waybill_sn,start_location,end_location,waybill_created_date,actual_eta,initial_eta,tri_punctuality_in_days
619438892,"SOUTH KEARNY TV, NJ","ATLANTA, GA",2023-07-07,-1,2,3
1087652210,"EDGERTON, IN","CANA, FL",2023-07-07,2,2,0
1087550549,"CHICAGO 47TH ST TV, IL","CHICAGO 47TH ST TV, IL",2023-07-07,6,4,-2
1087621552,"WARREN, PA","INWOOD, WV",2023-07-02,5,2,-3
3628757041,"CAROL, IN","FRANCISCO, IN",2023-07-07,3,5,2
3630200181,"WEST HAZLETON, PA","MARYLAND, LA",2023-07-07,8,5,-3
3630161133,"EDGERTON, IN","CANA, FL",2023-07-07,8,5,-3
3630104563,"MIAMI, FL","CHICAGO 47TH ST TV, IL",2023-07-07,5,5,0
1087595125,"PEDRICKTOWN, NJ","HOUSTON, TX",2023-07-07,1,3,2
3630062648,"LAMBERTS POINT, VA","WILLIAMSON YARD, WV",2023-07-07,7,9,2
1087685815,"CAREY, OH","DECATUR, IL",2023-07-07,-1,2,3
3630163656,"MERIDIAN, MS","RUTHERFORD, PA",2023-07-07,4,4,0
3630145789,"LOS ANGELES, CA","CHARLOTTE, NC",2023-07-07,9,6,-3
3630126727,"SHELBY, NC","CHARLOTTE, NC",2023-07-07,6,5,-1
1087530125,"LONG BEACH E PIER, CA","COLUMBUS, OH",2023-07-07,-2,1,3
1087567350,"AUSTELL, GA","LOS ANGELES, CA",2023-07-07,3,1,-2
3630212421,"VOLTZ MIX CTR, MO","MIAMI, FL",2023-07-07,1,2,1
3630215128,"SELMA, AL","QUINNESEC, MI",2023-07-07,2,1,-1
1087522449,"AUSTELL INTERMODAL, GA","PORTLAND, OR",2023-07-07,5,3,-2
3630080743,"HYCO, NC","BAILEY MINE, PA",2023-07-07,3,6,3
3630172809,"MARCUS, IA","ATLANTA, GA",2023-07-07,3,3,0
3630178253,"MELVINDALE, MI","KANSAS CITY, MO",2023-07-07,-1,1,2
3630203171,"LAMBERTS POINT, VA","TOMS CREEK, VA",2023-07-07,1,3,2
1087607281,"JESUS MARIA, SL","MELVINDALE, MI",2023-07-07,3,4,1
1087552583,"ST GABRIEL, LA","WEST HAZLETON, PA",2023-07-07,7,8,1
3630148614,"DECATUR, IL","DECATUR, IL",2023-07-07,0,2,2
3630084789,"NEW ORLEANS, LA","NEW ORLEANS, LA",2023-07-07,4,7,3
1087580976,"CROXTON, NJ","CHICAGO 47TH ST TV, IL",2023-07-07,8,6,-2
3630074190,"LOS ANGELES, CA","AUSTELL, GA",2023-07-07,1,4,3
3630148517,"DECATUR, IL","DECATUR, IL",2023-07-07,10,10,0
3630092180,"WELLSBORO, PA","WYEVILLE, WI",2023-07-07,6,6,0
1087639589,"TAFT, LA","INSTITUTE (KNWA), WV",2023-07-07,3,1,-2
1087544239,"ROSSER, GA","BARNESVILLE, GA",2023-07-07,8,7,-1
3630098746,"ASHEVILLE, NC","FALLON, NV",2023-07-07,8,6,-2
3630202913,"LAMBERTS POINT, VA","TOMS CREEK, VA",2023-07-02,5,4,-1
3628723458,"LAMBERTS POINT, VA","TOMS CREEK, VA",2023-07-07,7,7,0
3630126719,"DILLEY, TX","PICAYUNE, MS",2023-07-07,9,6,-3
3630109733,"LOUISVILLE, KY","LOUISVILLE, KY",2023-07-07,10,10,0
1087681552,"PELHAM, GA","NORTH MANCHESTER, IN",2023-07-07,2,5,3
1087607605,"MAPLE HEIGHTS, OH","NORFOLK INTERNATION, VA",2023-07-07,2,5,3
1087579551,"CROXTON, NJ","CHICAGO, IL",2023-07-07,-1,2,3
3630052871,"LEMOYNE, AL","MOBILE, AL",2023-07-07,3,4,1
1087689356,"CANNELTON (KNWA), WV","LAMBERTS POINT, VA",2023-07-07,10,9,-1
1087655747,"MORRISVILLE, PA","CHICAGO, IL",2023-07-07,1,4,3
3630105226,"CANTON, OH","UNION, SC",2023-07-07,4,6,2
3630118237,"COURTRIGHT, ON","BELEWS CREEK, NC",2023-07-07,8,10,2
1087621934,"CHICAGO, IL","APPLIANCE PARK, KY",2023-07-07,1,2,1
3630118889,"FARMERS VALLEY, PA","HOUSTON, TX",2023-07-07,7,9,2
3630194796,"FARMERS VALLEY, PA","WOODS CROSS, UT",2023-07-07,8,8,0
3630189539,"COLUMBIA CITY, IN","ST LOUIS, MO",2023-07-03,10,8,-2
3628888591,"WINSTON-SALEM, NC","WHITE PIGEON, MI",2023-07-07,8,10,2
3630074726,"ST GABRIEL, LA","WEST HAZLETON, PA",2023-07-07,6,9,3
3630217439,"KNOXVILLE, TN","ELDON, TX",2023-07-06,10,7,-3
1087199238,"LAMBERTS POINT, VA","TOMS CREEK, VA",2023-07-07,5,8,3
3630082321,"CHICAGO ASHLAND AVE, IL","DAKOTA CITY, NE",2023-07-07,6,8,2
3630174136,"EDGEMOOR, DE","CALVERT CITY, KY",2023-07-07,6,7,1
1087702308,"NEW ORLEANS, LA","NEW ORLEANS, LA",2023-07-07,8,10,2
3630113782,"CINCINNATI, OH","CINCINNATI, OH",2023-07-07,5,4,-1
3630054548,"CAROL, IN","FRANCISCO, IN",2023-07-07,2,2,0
3630204240,"ARCADE, NY","ABERDEEN, WA",2023-07-07,8,8,0
1087539446,"JACKSONVILLE, FL","ST LOUIS, MO",2023-07-07,10,7,-3
3630153724,"SHELBYVILLE MIX CTR, KY","BIG LIFT, CO",2023-07-07,2,1,-1
1087520154,"VOLTZ, MO","BETHINTERMODAL, PA",2023-07-07,-2,1,3
3630181913,"SELKIRK, NY","LAFAYETTE, IN",2023-07-07,7,10,3
3630162579,"ZORRA, ON","GORDON, GA",2023-07-07,5,4,-1
1087555303,"CAMPBELL ROAD YARD, OH","VON WILLER (CCRL), OH",2023-07-07,2,3,1
3630198295,"SCHENECTADY, NY","TAYLOR, PA",2023-07-06,9,9,0
1087461106,"WINSTON-SALEM, NC","WHITE PIGEON, MI",2023-07-07,11,8,-3
1087687736,"CLEVELAND, OH","COLUMBUS (CUOH), OH",2023-07-07,7,6,-1
1087627304,"MUNCY (LVRR), PA","LORDSTOWN, OH",2023-07-07,9,8,-1
1087624843,"CROXTON, NJ","KANSAS CITY, MO",2023-07-07,5,2,-3
3630166222,"NATKA (AIKR), SC","LAKE CHARLES, LA",2023-07-07,8,5,-3
1087692406,"ST LOUIS, MO","ST LOUIS, MO",2023-07-07,11,8,-3
1087667697,"CHARLESTON, SC","GREER, SC",2023-07-07,1,4,3
3630122082,"ATLANTA, GA","SANDERSVILLE, GA",2023-07-07,12,9,-3
1087521998,"CAROL, IN","FRANCISCO, IN",2023-07-07,0,3,3
3630184961,"TITUSVILLE, FL","CHICAGO 47TH ST TV, IL",2023-07-07,-1,2,3
1087560201,"LOS ANGELES, CA","AUSTELL, GA",2023-07-07,6,9,3
3630205482,"TAYLORSVILLE, MS","MONTPELIER, OH",2023-07-07,3,4,1
3630063149,"PANZACOLA, TL","MALLARD, AL",2023-07-07,3,4,1
3630167202,"GARY, IN","MIDWEST PORTAGE, IN",2023-07-07,3,4,1
3630068026,"ESCOBEDO, NL","CLEVELAND, OH",2023-07-07,9,7,-2
3630048694,"CICERO, IL","BETHINTERMODAL, PA",2023-07-07,7,4,-3
3630216920,"KNOXVILLE, TN","MOUNDSVILLE, WV",2023-07-07,8,9,1
1087532185,"LONG BEACH E PIER, CA","COLUMBUS, OH",2023-07-06,0,2,2
1087305342,"LAMBERTS POINT, VA","TOMS CREEK, VA",2023-07-07,8,8,0
3630184709,"YAZOO CITY, MS","TOMS CREEK, VA",2023-07-07,5,2,-3
3630115768,"RED DEER, AB","LOUISVILLE, KY",2023-07-07,6,9,3
3630178114,"WOODSTOCK, ON","WESTLAKE, FL",2023-07-07,2,2,0
3630122888,"MERIDIAN, MS","AUSTELL, GA",2023-07-07,1,2,1
1087645190,"LUDLOWVILLE (ITHR), NY","SHELBURNE, VT",2023-07-07,0,2,2
1087684110,"ELKHART, IN","SELMA, MO",2023-07-07,0,1,1
1087636167,"RUTHERFORD, PA","WYLIE, TX",2023-07-07,4,3,-1
1087672943,"JACKSONVILLE, FL","CALUMET, IL",2023-07-07,2,5,3
3630058893,"LOS ANGELES, CA","RUTHERFORD, PA",2023-07-07,7,8,1
1087594941,"HAVERHILL, OH","ALLEMANIA, LA",2023-07-03,3,3,0
3628888436,"WINSTON-SALEM, NC","WHITE PIGEON, MI",2023-07-07,7,10,3
1087563788,"CALVERT CITY, KY","EMORY GAP, TN",2023-07-07,-2,1,3
3630117655,"LOS ANGELES, CA","CROXTON, NJ",2023-07-07,2,3,1
1087650632,"PLEASANT VALLEY, VA","HOPEWELL, VA",2023-07-07,4,6,2
3630133229,"SELKIRK, NY","BUFFALO, NY",2023-07-07,3,1,-2
3630108664,"CLYMERS, IN","ALBION, MI",2023-07-07,5,4,-1
1087661633,"LADSON, SC","CLYATTVILLE, GA",2023-07-07,1,4,3
3630168680,"OAKWOOD, MI","GARY, IN",2023-07-07,1,4,3
1087619335,"SELKIRK, NY","BUFFALO, NY",2023-07-07,11,9,-2
3630180218,"GILBERTON, PA","FT WAYNE TBT, IN",2023-07-07,7,10,3
3630173936,"FLORENCE JCT, VT","WEST POINT, VA",2023-07-07,7,9,2
1087643025,"CHARLOTTE, NC","ICTF, CA",2023-07-07,7,5,-2
3630177485,"ASHEVILLE, NC","MARYLAND, LA",2023-07-07,2,4,2
1087592672,"LOUISVILLE, KY","LOUISVILLE, KY",2023-07-07,3,2,-1
3630213540,"RUTHERFORD, PA","CICERO, IL",2023-07-07,12,10,-2
3630107391,"SANDUSKY DOCK, OH","CROOKED CREEK MINE, PA",2023-07-07,4,6,2
1087540730,"INTERPUERTO, SL","AUSTELL, GA",2023-07-07,3,5,2
3630123397,"LIMA, OH","LORENZO, IL",2023-07-07,9,8,-1
3630175255,"TIPTON, IN","MACMILLAN, AL",2023-07-07,11,10,-1
3630127066,"BURNS HARBOR, IN","BURNS HARBOR, IN",2023-07-07,7,5,-2
3630175823,"MADAWASKA, ME","EVENDALE, OH",2023-07-07,5,5,0
3630065379,"LOS ANGELES, CA","CROXTON, NJ",2023-07-07,7,6,-1
3630094598,"CLAY, DE","GIBSON CITY, IL",2023-07-07,3,2,-1
3630077596,"DALLAS, TX","CROXTON, NJ",2023-07-07,3,2,-1
1087619911,"SELKIRK, NY","BUFFALO, NY",2023-07-07,7,6,-1
3630197930,"ALLEMANIA, LA","MECHANICSBURG, PA",2023-07-07,3,4,1
3630122032,"JESUS MARIA, SL","MELVINDALE, MI",2023-07-07,4,1,-3
3630110051,"LOUISVILLE, KY","LOUISVILLE, KY",2023-07-07,11,9,-2
1087580853,"OSCEOLA, AR","GRANITE CITY, IL",2023-07-07,10,8,-2
3630129602,"GREER, SC","CHARLESTON, SC",2023-07-07,5,2,-3
3630073461,"CHICAGO 47TH ST TV, IL","CHICAGO 47TH ST TV, IL",2023-07-07,13,10,-3
3630074572,"WEST HAZLETON, PA","CEDAR RAPIDS, IA",2023-07-07,9,6,-3
1087576228,"BIRMINGHAM, MO","CHICAGO HEIGHTS, IL",2023-07-07,1,3,2
3630127113,"BURNS HARBOR, IN","BURNS HARBOR, IN",2023-07-07,3,6,3
1087646007,"SHARONVILLE, OH","NORFOLK INTERNATION, VA",2023-07-07,6,3,-3
3630139940,"DECATUR, IL","BIRMINGHAM, AL",2023-07-07,-1,2,3
3630107333,"SANDUSKY DOCK, OH","CROOKED CREEK MINE, PA",2023-07-07,12,9,-3
3630159526,"WINNIPEG, MB","HOPEWELL, VA",2023-07-07,10,10,0
1087668643,"BIRMINGHAM, AL","BARNESVILLE, GA",2023-07-07,3,1,-2
1087673787,"MELVINDALE, MI","KANSAS CITY, MO",2023-07-07,2,5,3
1087521922,"CAROL, IN","FRANCISCO, IN",2023-07-07,7,8,1
3630079077,"WINSTON-SALEM, NC","RABER, IN",2023-07-07,5,2,-3
3630120917,"WOODSTOCK, ON","COMMERCE, GA",2023-07-07,6,9,3
3630128907,"LIMA, OH","FOSTORIA, OH",2023-07-07,7,7,0
3630125551,"GASTONIA, NC","ROBERTA, AL",2023-07-07,5,8,3
3630072732,"CLEWISTON, FL","TYNER, TN",2023-07-07,9,7,-2
1087561029,"HYCO, NC","BAILEY MINE, PA",2023-07-07,1,3,2
1087649982,"FREEPORT, TX","STATESBORO, GA",2023-07-07,6,9,3
3630055934,"MERIDIAN, MS","CHARLOTTE, NC",2023-07-07,7,5,-2
3630085858,"BOWDEN YARD, FL","CHICAGO 47TH ST TV, IL",2023-07-07,8,6,-2
1087613169,"TOLEDO, OH","INDIANA HARBOR, IN",2023-07-07,4,4,0
3630092261,"WELLSBORO, PA","WYEVILLE, WI",2023-07-07,4,5,1
3630048597,"CICERO, IL","CROXTON, NJ",2023-07-07,5,8,3
1087646308,"LOS ANGELES, CA","AUSTELL, GA",2023-07-07,0,1,1
1087704994,"GEORGETOWN, KY","TACOMA, WA",2023-07-07,8,5,-3
1087693698,"SANDERSVILLE, GA","MAHRT (CCH), AL",2023-07-07,8,5,-3
3630109911,"LOUISVILLE, KY","LOUISVILLE, KY",2023-07-07,3,1,-2
1087682388,"CHICAGO, IL","CHICAGO MIX CTR, IL",2023-07-07,7,4,-3
1087611727,"MALLARD, AL","DECATUR, AL",2023-07-07,7,7,0
1087711658,"EAST BINGHAMTON, NY","EAST BINGHAMTON, NY",2023-07-07,4,4,0
3630076451,"LOS ANGELES, CA","JACKSONVILLE, FL",2023-07-07,6,3,-3
3630067957,"CHARLOTTE INTER, NC","CHARLOTTE INTER, NC",2023-07-07,-2,1,3
3630151324,"DECATUR, IL","HOMER, IL",2023-07-07,4,6,2
3630130475,"UNION BRIDGE, MD","DURHAM, NC",2023-07-07,6,3,-3
1087573092,"TAYLOR, PA","SCHENECTADY, NY",2023-07-07,12,10,-2
3630213817,"ASHEVILLE, NC","SMYTH (BLU), NC",2023-07-07,9,6,-3
3630182977,"ORLANDO, FL","SIDNEY, IL",2023-07-07,5,5,0
3630129856,"DARROW, IL","LAFAYETTE, IN",2023-07-07,9,9,0
3630196421,"WYLIE, TX","CROXTON, NJ",2023-07-02,9,6,-3
3628755811,"CAROL, IN","FRANCISCO, IN",2023-07-07,5,2,-3
3630063034,"ST PAUL, MN","AUSTELL, GA",2023-07-07,12,10,-2
3630179479,"LAMBERTS POINT, VA","WILLIAMSON YARD, WV",2023-07-07,0,1,1
3630074077,"LAGRANGE, NL","DODGE CITY, MI",2023-07-07,1,3,2
1087667215,"AUGUSTA, GA","LULING, LA",2023-07-07,3,6,3
3630104416,"MAGNOLIA, GA","ROBERTA, AL",2023-07-07,11,9,-2
3630156196,"ELDON, TX","MONTGOMERY, NY",2023-07-07,9,6,-3
3630200131,"BENTONITE, WY","ARCHBOLD, OH",2023-07-07,1,2,1
1087521613,"CAROL, IN","FRANCISCO, IN",2023-07-07,4,2,-2
3630177605,"CARROLL, TN","LEEDS, AL",2023-07-07,6,7,1
3630169181,"GEISMAR, LA","ELLISVILLE, MS",2023-07-07,2,5,3
3630077774,"LOS ANGELES, CA","JACKSONVILLE, FL",2023-07-07,4,4,0
1087701459,"PITTSBURGH, PA","CHICAGO, IL",2023-07-07,5,5,0
3630170132,"LAFAYETTE, IN","LAFAYETTE, IN",2023-07-07,6,5,-1
1087657228,"DES MOINES, IA","DES MOINES, IA",2023-07-07,12,10,-2
3630141688,"SOLVAY, NY","MOORESVILLE, NC",2023-07-07,1,4,3
3630143826,"BAYARD, FL","MODESTO, CA",2023-07-07,5,5,0
3630147375,"DECATUR, IL","DECATUR, IL",2023-07-07,3,6,3
3630131382,"ORANGEBURG, SC","EDGERTON, IN",2023-07-07,1,3,2
1087539218,"MONROE, MI","CHICAGO, IL",2023-07-07,4,5,1
1087603708,"FARMERS VALLEY, PA","HOUSTON, TX",2023-07-07,4,4,0
1087654416,"MERIDIAN, MS","ATLANTA, GA",2023-07-07,9,9,0
3630094182,"MEMPHIS, TN","AUSTELL INTERMODAL, GA",2023-07-07,2,2,0
1087533123,"CLEVELAND, OH","GRANITE CITY, IL",2023-07-07,6,5,-1
1087659343,"OAKWOOD, MI","GARY, IN",2023-07-07,6,6,0
3630211132,"LAKE CHARLES, LA","ASHEBORO, NC",2023-07-02,0,1,1
3628723165,"LAMBERTS POINT, VA","TOMS CREEK, VA",2023-07-07,2,5,3
3630098851,"ASHEVILLE, NC","NORANDA, PQ",2023-07-07,9,9,0
1087707691,"WINSTON-SALEM, NC","HOBBS, IN",2023-07-07,8,9,1
1087595557,"RED DEER, AB","SYLACAUGA, AL",2023-07-07,1,3,2
3630124589,"TACSIM, WA","AUSTELL, GA",2023-07-07,6,9,3
3630211352,"WINSTON-SALEM, NC","HOBBS, IN",2023-07-07,7,5,-2
1087663994,"WILMINGTON, CA","PORT NEWARK ELIZABE, NJ",2023-07-07,13,10,-3
3630123949,"FLINT RIVER, GA","PARIS, TX",2023-07-07,5,7,2
3630126599,"DILLEY, TX","PICAYUNE, MS",2023-07-02,12,10,-2
3628671685,"CHARLOTTE, NC","WHITE PIGEON, MI",2023-07-07,6,7,1
3630178790,"PALMERTON, PA","COLUMBIA CITY, IN",2023-07-07,9,10,1
3630053217,"LAMBERTS POINT, VA","WILLIAMSON YARD, WV",2023-07-07,10,8,-2
3630194372,"SINKING SPRING, PA","DYERSVILLE, IA",2023-07-07,3,6,3
3630054726,"CAROL, IN","FRANCISCO, IN",2023-07-07,2,5,3
3630129026,"PAULSBORO, NJ","TULSA, OK",2023-07-07,8,8,0
3630180543,"SANDY SPRINGS, SC","CABOT, LA",2023-07-07,0,1,1
3630084844,"MEHOOPANY, PA","PHILADELPHIA, PA",2023-07-07,8,10,2
3630058631,"LONG BEACH E PIER, CA","COLUMBUS, OH",2023-07-07,10,10,0
1087538610,"FERGUSON, MS","BRAMPTON, GA",2023-07-07,3,5,2
3630110475,"ATHERTON, IN","NEAL, WV",2023-07-07,4,1,-3
1087623237,"GRANITE CITY, IL","HOPEWELL, VA",2023-07-07,1,2,1
1087532973,"TOLEDO AIRLINE, OH","TOLEDO AIRLINE, OH",2023-07-07,3,6,3
3630210673,"CLEARING CHGO, IL","BUTLER, IA",2023-07-07,6,8,2
3630152087,"EAST ST LOUIS, IL","BLUFFTON, IN",2023-07-07,6,4,-2
3630109547,"RED DEER, AB","DANVILLE, KY",2023-07-07,4,1,-3
3630171324,"YOUNGSTOWN, OH","NORTH BERGEN, NJ",2023-07-07,4,5,1
3630064917,"MONROE, MI","THUNDER JCT WEST, WY",2023-07-07,9,8,-1
1087716064,"MUNCY (LVRR), PA","BUTLER, PA",2023-07-07,8,5,-3
3630132728,"SELKIRK, NY","BUFFALO, NY",2023-07-07,9,8,-1
3630209020,"MAHANOY CITY, PA","BILLINGS, MT",2023-07-07,10,8,-2
3630196201,"DECATUR, AL","WYTHEVILLE, VA",2023-07-07,4,7,3
1087619408,"SELKIRK, NY","BUFFALO, NY",2023-07-07,3,1,-2
1087659929,"OAKWOOD, MI","GARY, IN",2023-07-07,6,6,0
3630068589,"CHICAGO, IL","COLUMBUS, OH",2023-07-07,7,5,-2
3630121947,"AUBURNDALE, FL","JACKSONVILLE, FL",2023-07-07,-2,1,3
1087559462,"COLUMBIA CITY, IN","EAST CHICAGO, IN",2023-07-03,4,6,2
3628888711,"WINSTON-SALEM, NC","WHITE PIGEON, MI",2023-07-07,0,1,1
3630207175,"ALTOONA, PA","PORTSMOUTH, OH",2023-07-07,4,2,-2
3630163240,"DALLAS, TX","CROXTON, NJ",2023-07-07,7,7,0
3630181963,"MIDWEST PORTAGE, IN","GARY, IN",2023-07-07,8,8,0
3630078631,"LOS ANGELES, CA","AUSTELL, GA",2023-07-07,7,9,2
1087602401,"HARRISBURG, NC","CLYATTVILLE, GA",2023-07-07,6,8,2
1087545798,"SAN BERNARDINO, CA","JACKSONVILLE, FL",2023-07-07,7,8,1
1087707405,"WINSTON-SALEM, NC","HOBBS, IN",2023-07-07,2,3,1
1087671442,"CHARLOTTE, NC","LOS ANGELES, CA",2023-07-07,1,2,1
1087552486,"CLEWISTON, FL","TYNER, TN",2023-07-07,2,1,-1
3630210241,"ORRVILLE, OH","EAST DECATUR, IL",2023-07-07,8,5,-3
3630114615,"ORANGE, TX","SANDY SPRINGS, SC",2023-07-02,4,7,3
3628755861,"CAROL, IN","FRANCISCO, IN",2023-07-07,6,6,0
3630080175,"HYCO, NC","BAILEY MINE, PA",2023-07-07,8,9,1
3630064967,"MONROE, MI","THUNDER JCT WEST, WY",2023-07-07,6,3,-3
3630163753,"MERIDIAN, MS","ATLANTA, GA",2023-07-02,2,4,2
3628672275,"CHARLOTTE, NC","WHITE PIGEON, MI",2023-07-07,2,4,2
3630125331,"RIVER ROUGE, MI","DETROIT, MI",2023-07-07,9,10,1
3630177574,"CARROLL, TN","LEEDS, AL",2023-07-07,-2,1,3
3630109416,"MUNCY (LVRR), PA","TOLEDO, OH",2023-07-07,3,2,-1
3630132621,"LAMBERTS POINT, VA","WILLIAMSON YARD, WV",2023-07-07,9,8,-1
3630143787,"BAYARD, FL","MODESTO, CA",2023-07-07,10,9,-1
3630186890,"TACOMA EXPORT, WA","COLUMBUS, OH",2023-07-07,2,1,-1
1087537232,"LAMBERTS POINT, VA","WILLIAMSON YARD, WV",2023-07-07,0,3,3
3630151154,"DECATUR, IL","HOMER, IL",2023-07-07,6,4,-2
3630060002,"REYBOLD, DE","YULEE, FL",2023-07-07,-1,1,2
3630145226,"WENTZVILLE, MO","VIBORILLAS, QA",2023-07-06,5,7,2
1087267536,"LAMBERTS POINT, VA","TOMS CREEK, VA",2023-07-07,3,4,1
3630211718,"WINSTON-SALEM, NC","HOBBS, IN",2023-07-02,11,10,-1
3628756516,"CAROL, IN","FRANCISCO, IN",2023-07-07,3,3,0
3630147040,"CHOCOWINITY, NC","HODGES, TN",2023-07-07,9,9,0
1087562041,"CALVERT, AL","INDIANA HARBOR, IN",2023-07-07,10,7,-3
3630156065,"ELDON, TX","STATESBORO, GA",2023-07-07,8,10,2
3630086993,"KANSAS CITY, MO","MELVINDALE, MI",2023-07-07,5,7,2
1087597583,"ROSSVILLE, TN","RUTHERFORD, PA",2023-07-07,5,2,-3
1087538775,"ALBANY, NY","CHICAGO, IL",2023-07-07,13,10,-3
3630212099,"GEISMAR, LA","BOYCE, TN",2023-07-07,4,4,0
3630102642,"DELAIR, NJ","LA PORTE, TX",2023-07-06,7,10,3
3629777777,"LAMBERTS POINT, VA","TOMS CREEK, VA",2023-07-07,10,9,-1
1087687613,"KEOKUK, IA","ELIZABETHTOWN, PA",2023-07-07,2,4,2
3630095413,"GATEWAY MINE, IL","WHEATFIELD, IN",2023-07-07,10,8,-2
3630118839,"FARMERS VALLEY, PA","HOUSTON, TX",2023-07-07,7,8,1
1087655501,"CHARLOTTE, NC","CHICAGO, IL",2023-07-07,8,6,-2
3630092203,"WELLSBORO, PA","WYEVILLE, WI",2023-07-07,3,2,-1
3630176049,"JERSEY, TN","CLYMERS, IN",2023-07-07,8,10,2
3630163931,"SHARONVILLE, OH","KALIUM, SK",2023-07-02,3,4,1
3628722850,"LAMBERTS POINT, VA","TOMS CREEK, VA",2023-07-07,0,3,3
3630093136,"BAIR, PA","BENTONITE, WY",2023-07-07,10,8,-2
3630064721,"MONROE, MI","THUNDER JCT WEST, WY",2023-07-07,2,2,0
3630174380,"PERRY, OH","PERRY, OH",2023-07-07,6,5,-1
3630218697,"BAINBRIDGE, GA","SANDERSVILLE, MS",2023-07-07,9,6,-3
1087642778,"EAST ST LOUIS, IL","BLUFFTON, IN",2023-07-07,9,6,-3
3630148347,"DECATUR, IL","DECATUR, IL",2023-07-06,1,3,2
1087305481,"LAMBERTS POINT, VA","TOMS CREEK, VA",2023-07-07,12,9,-3
3630144636,"STRANG, TX","MCINTOSH, AL",2023-07-07,6,7,1
1087557826,"LOS ANGELES, CA","JACKSONVILLE, FL",2023-07-07,2,5,3
3630156015,"ELDON, TX","SOUTH HIGH POINT, NC",2023-07-07,2,3,1
3630205759,"WARRENTON, OH","SPARTA, WI",2023-07-07,9,8,-1
3630205694,"WARRENTON, OH","SPARTA, WI",2023-07-07,6,6,0
3630131934,"JACKSON, MI","COLUMBIA CITY, IN",2023-07-07,3,4,1
3630187074,"MCCOLL, SC","STRASBURG, PA",2023-07-07,8,9,1
1087542392,"GEORGETOWN, KY","PHOENIX, AZ",2023-07-07,5,4,-1
3630194039,"HARROWBY, MB","ONEONTA, NY",2023-07-07,8,10,2
3630170182,"SOUTH RALEIGH, NC","WOODLAWN, AL",2023-07-07,7,7,0
1087694149,"AUSTELL, GA","GREER, SC",2023-07-07,3,3,0
3630167854,"MUNCY (LVRR), PA","LORDSTOWN, OH",2023-07-07,2,1,-1
3630144686,"CELCO, VA","PASADENA, TX",2023-07-07,2,5,3
3630079726,"CITY OF INDUSTRY, CA","GREENSBORO, NC",2023-07-07,6,7,1
1087552533,"CLEWISTON, FL","TYNER, TN",2023-07-07,6,4,-2
1087653389,"MONROE, MI","HAINESPORT, NJ",2023-07-07,6,3,-3
1087677812,"ASH, MI","LIVERNOIS, MI",2023-07-02,10,7,-3
3628756346,"CAROL, IN","FRANCISCO, IN",2023-07-07,3,5,2
3630056956,"LONG BEACH E PIER, CA","CLEVELAND, OH",2023-07-07,6,3,-3
1087686879,"BETHINTERMODAL, PA","ROSSVILLE, TN",2023-07-07,7,10,3
1087574284,"WAYNESBURG, PA","BETHLEHEM, PA",2023-07-07,8,7,-1
3630051118,"LAMBERTS POINT, VA","WILLIAMSON YARD, WV",2023-07-07,9,9,0
3630073267,"CLINTON, IA","VILLA RICA, GA",2023-07-07,0,2,2
3630199796,"CEDAR RAPIDS, IA","CITY POINT, FL",2023-07-07,13,10,-3
1087581273,"GENEVA (FGLK), NY","CORNING, NY",2023-07-07,3,4,1
3630054687,"CAROL, IN","FRANCISCO, IN",2023-07-07,3,3,0
3630199102,"PORTLAND, OR","CHARLOTTE, NC",2023-07-07,9,6,-3
3630064373,"RICHMOND, VA","TROUTVILLE, VA",2023-07-07,6,8,2
3630181612,"SELKIRK, NY","LAFAYETTE, IN",2023-07-07,7,8,1
3630207997,"MOGADORE, OH","WARWICK, SC",2023-07-07,10,10,0
3630107553,"SANDUSKY DOCK, OH","CROOKED CREEK MINE, PA",2023-07-07,10,9,-1
1087691947,"DECATUR, AL","FRANKLIN, IN",2023-07-07,1,4,3
3630193198,"MIRAMICHI, NB","MILFORD (DCR), DE",2023-07-06,8,5,-3
3629821267,"SURRENCY, GA","ANDERSON (ICRK), IN",2023-07-07,3,4,1
3630122600,"ARMOREL, AR","SAVANNAH, GA",2023-07-07,4,1,-3
3630086799,"SHELBURNE, VT","LUDLOWVILLE (ITHR), NY",2023-07-07,5,8,3
3630066016,"CHICAGO, IL","CHICAGO, IL",2023-07-07,2,3,1
1087596163,"CLEVELAND, OH","LONG BEACH E PIER, CA",2023-07-07,9,6,-3
1087596537,"MACUNGIE, PA","MONROE, WI",2023-07-07,0,1,1
3630188371,"TACOMA EXPORT, WA","COLUMBUS, OH",2023-07-07,6,7,1
3630198978,"LA PORTE, TX","GRIFFIN, GA",2023-07-07,6,5,-1
3630104783,"CARROLLTON, GA","FORMOSA, TX",2023-07-07,5,7,2
3630151285,"DECATUR, IL","HOMER, IL",2023-07-07,4,6,2
3630205157,"YULEE, FL","LOCKBOURNE, OH",2023-07-07,8,6,-2
1087716048,"PHOENIX, NJ","CHICAGO, IL",2023-07-07,3,6,3
3630135857,"BOWDEN YARD, FL","CHARLOTTE, NC",2023-07-07,3,6,3
1087550507,"CHICAGO 47TH ST TV, IL","CHICAGO 47TH ST TV, IL",2023-07-07,7,4,-3
1087616167,"UNION BRIDGE, MD","DURHAM, NC",2023-07-07,5,3,-2
3630212895,"EVADALE, TX","LOFTON, VA",2023-07-07,13,10,-3
3630182511,"SANDERSVILLE, GA","TAFT, LA",2023-07-07,4,5,1
1087679092,"DEER PARK, TX","LOUISVILLE, KY",2023-07-07,7,6,-1
1087636808,"CLAVET, SK","GAINESVILLE, GA",2023-07-07,7,5,-2
3630191081,"BAYONNE, NJ","WEST LAKE, LA",2023-07-07,2,3,1
3630127684,"TOLEDO, OH","INDIANA HARBOR, IN",2023-07-07,9,8,-1
1087710288,"ASHEVILLE, NC","SMYTH (BLU), NC",2023-07-07,4,1,-3
1087619678,"SELKIRK, NY","BUFFALO, NY",2023-07-07,3,2,-1
3630137126,"SALINAS VICTORIA, NL","CHARLOTTE, NC",2023-07-07,9,6,-3
1087695925,"WAUSAU, WI","FRANKLIN, OH",2023-07-07,3,4,1
1087577541,"GATEWAY MINE, IL","WHEATFIELD, IN",2023-07-07,1,1,0
3630205953,"WHEELER, WA","DORAVILLE, GA",2023-07-07,9,10,1
3630109610,"RED DEER, AB","SYLACAUGA, AL",2023-07-07,10,8,-2
3630173910,"FLORENCE JCT, VT","WEST POINT, VA",2023-07-07,8,7,-1
3630151015,"DECATUR, IL","HOMER, IL",2023-07-07,11,8,-3
3630099598,"THOMASVILLE, PA","GEISMAR, LA",2023-07-07,5,4,-1
3630118059,"CRESSON, PA","CRAB ORCHARD, TN",2023-07-07,11,9,-2
3630069103,"ROSSER, GA","BARNESVILLE, GA",2023-07-07,10,8,-2
3630089658,"ST PAUL, MN","HARRISBURG, PA",2023-07-02,1,2,1
3628672013,"CHARLOTTE, NC","WHITE PIGEON, MI",2023-07-07,2,3,1
3630203278,"LAMBERTS POINT, VA","TOMS CREEK, VA",2023-07-07,3,6,3
3630153148,"COLUMBUS, OH","BUTLER, IN",2023-07-06,7,4,-3
1087460613,"WINSTON-SALEM, NC","WHITE PIGEON, MI",2023-07-07,10,7,-3
3630141442,"ASHEVILLE, NC","BAYTOWN, TX",2023-07-07,5,8,3
3630065109,"SIDNEY, OH","LEBANON, PA",2023-07-07,13,10,-3
3630179005,"LATHROP, CA","JACKSONVILLE, FL",2023-07-07,3,2,-1
1087562944,"GARDEN CITY, GA","NEW ORLEANS, LA",2023-07-07,12,10,-2
1087652260,"WAYNE, MI","ECORSE, MI",2023-07-07,12,9,-3
1087543550,"CHICAGO, IL","COLUMBUS, OH",2023-07-07,5,8,3
1087557737,"ROANOKE, VA","PORT WILMINGTON, DE",2023-07-07,-1,1,2
1087591236,"VALDOSTA, GA","BURNSVILLE, MS",2023-07-07,8,8,0
1087538555,"LEIPSIC, OH","PORTAGE, IN",2023-07-07,5,6,1
1087567635,"GREENEVILLE, TN","LIPE, TN",2023-07-07,6,3,-3
3630145519,"ELDON, TX","MONTGOMERY, NY",2023-07-07,4,6,2
3630197427,"NORTH BIRMINGHAM, AL","SPOCARI, AL",2023-07-07,5,8,3
3630075895,"MERIDIAN, MS","CHARLOTTE, NC",2023-07-07,5,6,1
1087543021,"CHARLOTTE INTER, NC","WYLIE, TX",2023-07-07,9,7,-2
3630126612,"MONROE, MI","NORTH BERGEN, NJ",2023-07-07,6,8,2
3630209525,"BAYWAY, NJ","CHICAGO, IL",2023-07-07,3,4,1
1087531163,"BELLEVUE, OH","BELLEVUE, OH",2023-07-07,9,8,-1
3630099661,"CALEDONIA, NY","EAGLE GROVE, IA",2023-07-07,3,3,0
1087539967,"LOS ANGELES, CA","CROXTON, NJ",2023-07-07,7,8,1
3630114649,"ORANGE, TX","DAYTON, TN",2023-07-07,7,10,3
1087610446,"LOS ANGELES, CA","AUSTELL, GA",2023-07-07,7,6,-1
1087519543,"CROXTON, NJ","CHICAGO, IL",2023-07-07,10,9,-1
3630166191,"NATKA (AIKR), SC","LAKE CHARLES, LA",2023-07-07,10,9,-1
3630204004,"YORKTON, SK","HILLSIDE, NJ",2023-07-07,2,4,2
3630057009,"DORAVILLE, GA","ENGEN, BC",2023-07-07,8,8,0
3630108339,"VALDOSTA, GA","BURNSVILLE, MS",2023-07-07,8,7,-1
1087649453,"EATONTON, GA","VANCE, AL",2023-07-07,8,9,1
3630145933,"WESTON, ON","BALTIMORE, MD",2023-07-07,6,9,3
1087604186,"MEXICO, MO","MEXICO, MO",2023-07-07,5,4,-1
3630063856,"LOS ANGELES, CA","CROXTON, NJ",2023-07-02,12,10,-2
3628756435,"CAROL, IN","FRANCISCO, IN",2023-07-07,6,8,2
3630188884,"VON WILLER (CCRL), OH","CLEVELAND, OH",2023-07-07,8,7,-1
3630081121,"HYCO, NC","BAILEY MINE, PA",2023-07-07,9,8,-1
1087602582,"COLUMBUS, OH","LONG BEACH E PIER, CA",2023-07-07,10,10,0
1087672210,"PALMERTON, PA","BLACKSBURG, SC",2023-07-07,5,8,3
3630058788,"LONG BEACH E PIER, CA","CLEVELAND, OH",2023-07-07,3,4,1
1087569970,"MINOT, ND","HARRISBURG, PA",2023-07-07,4,4,0
3630179526,"NORTH VALLIANT, OK","MADISON, AL",2023-07-07,10,8,-2
3630116641,"SELMA, NC","DECATUR, IL",2023-07-07,7,9,2
3630187634,"LOGISTICS PARK CHIC, IL","CHICAGO, IL",2023-07-07,8,5,-3
3630199568,"CEDAR RAPIDS, IA","PETERSBURG, VA",2023-07-07,5,5,0
1087702853,"CLINTON, IA","DOUGHERTY, GA",2023-07-07,3,2,-1
1087689534,"CANNELTON (KNWA), WV","LAMBERTS POINT, VA",2023-07-07,5,7,2
3630056029,"MERIDIAN, MS","CHARLOTTE, NC",2023-07-07,10,7,-3
1087581485,"ASHEVILLE, NC","PINE BLUFF, AR",2023-07-07,5,7,2
3630099611,"THOMASVILLE, PA","GEISMAR, LA",2023-07-07,9,6,-3
1087715482,"YORK, PA","EAST ST LOUIS, IL",2023-07-07,6,4,-2
3630068165,"ST PAUL, MN","HARRISBURG, PA",2023-07-07,9,10,1
3630080997,"HYCO, NC","BAILEY MINE, PA",2023-07-07,4,5,1
1087625132,"MIAMI, FL","CHICAGO 47TH ST TV, IL",2023-07-07,9,7,-2
1087605823,"MARTINSBURG, WV","LEETSDALE, PA",2023-07-07,5,5,0
1087533246,"WYSOX, PA","WEDRON, IL",2023-07-07,2,3,1
3630217007,"BUTLER, IN","TOLEDO, OH",2023-07-07,1,1,0
3630058916,"SAN BERNARDINO, CA","GREENSBORO, NC",2023-07-07,10,7,-3
3630073322,"CLINTON, IA","VILLA RICA, GA",2023-07-07,1,1,0
3630085832,"BOWDEN YARD, FL","CHICAGO 47TH ST TV, IL",2023-07-07,6,9,3
3630164872,"STERLING HEIGHTS, MI","ROLLA, CO",2023-07-07,4,3,-1
3630084632,"RUBY, GA","JACKSONVILLE, FL",2023-07-07,-2,1,3
1087649445,"WYLIE, TX","ATLANTA, GA",2023-07-07,7,4,-3
3630105048,"BAYTOWN, TX","NORCROSS, GA",2023-07-07,6,8,2
3630074687,"AMELIA, TX","LYNCHBURG, VA",2023-07-04,8,7,-1
3629134000,"SANDUSKY DOCK, OH","CROOKED CREEK MINE, PA",2023-07-07,2,4,2
1087598377,"MILLEN, GA","NEWBERRY, PA",2023-07-07,3,2,-1
1087550434,"CHICAGO 47TH ST TV, IL","JACKSONVILLE, FL",2023-07-07,4,6,2
3630118758,"WEST CRESSONA, PA","KIMBALL, NE",2023-07-07,6,6,0
1087550840,"CHICAGO 47TH ST TV, IL","CROXTON, NJ",2023-07-07,6,9,3
3630169238,"ZORRA, ON","SIEGFRIED, PA",2023-07-07,4,3,-1
3630199039,"LA PORTE, TX","GRIFFIN, GA",2023-07-07,10,10,0
1087577494,"GATEWAY MINE, IL","WHEATFIELD, IN",2023-07-07,1,3,2
3630095803,"GATEWAY MINE, IL","WHEATFIELD, IN",2023-07-07,9,8,-1
3630049496,"PORT WENTWORTH, GA","TYNER, TN",2023-07-07,6,4,-2
1087596414,"COLUMBUS, OH","TACOMA, WA",2023-07-07,10,8,-2
3630211522,"BAYTOWN, TX","JEFFERSON, OH",2023-07-07,9,9,0
3630186719,"SANTA TERESA RAMP, NM","AUSTELL, GA",2023-07-07,3,1,-2
3630209981,"HOPKINSVILLE, KY","WENTZVILLE, MO",2023-07-07,11,10,-1
1087658973,"OAKWOOD, MI","CLEVELAND, OH",2023-07-07,5,7,2
3630169068,"LORENZO, IL","NEW ORLEANS, LA",2023-07-07,6,8,2
3630180161,"SHENANDOAH, PA","CLOVER BAR, AB",2023-07-07,6,7,1
1087518416,"CROXTON, NJ","DALLAS, TX",2023-07-07,8,9,1
3630138562,"CLEARING CHGO, IL","BURNHAM, PA",2023-07-07,10,9,-1
3630073259,"CLINTON, IA","LOUISVILLE, KY",2023-07-07,4,2,-2
3630185129,"TATE COVE, LA","GRANITEVILLE, SC",2023-07-07,4,3,-1
3630063115,"QUERETARO, QA","MALLARD, AL",2023-07-03,9,7,-2
3628888703,"WINSTON-SALEM, NC","WHITE PIGEON, MI",2023-07-07,13,10,-3
3630068377,"CHICAGO, IL","CROXTON, NJ",2023-07-07,11,10,-1
3630121612,"INSTITUTE (KNWA), WV","TAFT, LA",2023-07-07,8,5,-3
3630098550,"ASHEVILLE, NC","PINE BLUFF, AR",2023-07-07,9,9,0
3630080183,"HYCO, NC","BAILEY MINE, PA",2023-07-07,6,8,2
3630159005,"MEMPHIS, TN","NORFOLK, VA",2023-07-07,6,8,2
3630061684,"KANSAS CITY, MO","KANSAS CITY, MO",2023-07-07,5,8,3
1087610022,"ERIE, PA","OLD OCEAN, TX",2023-07-07,12,10,-2
1087689665,"CANNELTON (KNWA), WV","LAMBERTS POINT, VA",2023-07-07,2,4,2
3630058071,"LONG BEACH E PIER, CA","CINCINNATI, OH",2023-07-07,13,10,-3
3630107456,"SANDUSKY DOCK, OH","CROOKED CREEK MINE, PA",2023-07-07,8,5,-3
1087672139,"PORT ARTHUR, TX","SELMA, NC",2023-07-07,3,5,2
1087557787,"REDWOOD, MS","LEMOYNE, AL",2023-07-07,-1,1,2
3630132859,"SELKIRK, NY","BUFFALO, NY",2023-07-07,4,2,-2
3630120111,"SINCO, TX","LOUISVILLE, KY",2023-07-07,1,2,1
3630116382,"LYNCHBURG, VA","MACMILLAN, AL",2023-07-07,9,6,-3
1087649380,"JACKSONVILLE, FL","RUTHERFORD, PA",2023-07-07,10,9,-1
3630059784,"MORRISTOWN, TN","EAST GRAND FORKS, MN",2023-07-07,0,1,1
3630194102,"TITUSVILLE, FL","SAN BERNARDINO, CA",2023-07-07,9,9,0
1087520049,"CROXTON, NJ","CHICAGO, IL",2023-07-07,0,3,3
3630103127,"COATESVILLE, PA","KOPPEL, PA",2023-07-07,4,1,-3
3630056118,"MERIDIAN, MS","CHARLOTTE, NC",2023-07-07,-2,1,3
3630141418,"ROANOKE, VA","HUNTINGBURG, IN",2023-07-07,11,8,-3
1087652244,"EDGERTON, IN","CANA, FL",2023-07-04,7,10,3
1086404737,"SANDUSKY DOCK, OH","CROOKED CREEK MINE, PA",2023-07-07,2,5,3
1087687477,"DORAVILLE, GA","CALDWELL, ID",2023-07-07,6,9,3
3630172532,"BELLEVUE, OH","BROADWAY, VA",2023-07-07,3,6,3
1087681138,"ANDERSONVILLE, GA","WHEELERSBURG, OH",2023-07-07,1,3,2
1087614830,"RUTHERFORD, PA","KANSAS CITY, MO",2023-07-02,9,6,-3
3628723204,"LAMBERTS POINT, VA","TOMS CREEK, VA",2023-07-07,-2,1,3
3630146256,"COLUMBUS, OH","KRANNERT, GA",2023-07-07,5,7,2
1087612058,"MALLARD, AL","DECATUR, AL",2023-07-07,4,1,-3
1087671337,"MELVINDALE, MI","KANSAS CITY, MO",2023-07-04,2,2,0
3629203493,"LAMBERTS POINT, VA","TOMS CREEK, VA",2023-07-07,4,4,0
3630189107,"YORK, PA","MIDDLETOWN, CT",2023-07-07,9,8,-1
3630178148,"LAMBERTS POINT, VA","WILLIAMSON YARD, WV",2023-07-07,4,2,-2
3630196112,"CEDAR RAPIDS, IA","BATTLE CREEK, MI",2023-07-07,8,10,2
3630075382,"LOS ANGELES, CA","CROXTON, NJ",2023-07-07,4,7,3
1087662346,"AYER, MA","IVORYDALE, OH",2023-07-07,8,9,1
1087540780,"ROSSVILLE, TN","CROXTON, NJ",2023-07-07,7,9,2
3630065654,"MONROE, MI","CHICAGO, IL",2023-07-07,10,10,0
3630122731,"MUNCIE, IN","ALLEMANIA, LA",2023-07-07,5,4,-1
3630137744,"CHICAGO ASHLAND AVE, IL","RUEBEL, MN",2023-07-07,4,4,0
3630132794,"SELKIRK, NY","BUFFALO, NY",2023-07-07,8,9,1
3630112451,"RED DEER, AB","MORRISTOWN, TN",2023-07-07,5,4,-1
1087571545,"CHICAGO, IL","MORRISVILLE, PA",2023-07-07,5,6,1
3630077805,"CITY OF INDUSTRY, CA","GREENSBORO, NC",2023-07-07,4,6,2
3630173601,"DEER PARK, TX","TOLEDO, OH",2023-07-07,10,7,-3
3630148567,"DETROIT FLEXI FLO, MI","MARYLAND, LA",2023-07-07,13,10,-3
3630139885,"WOODSTOCK, ON","WESTLAKE, FL",2023-07-07,4,4,0
3630118512,"CRESSON, PA","CLEVELAND, OH",2023-07-07,5,2,-3
3630126769,"DILLEY, TX","PICAYUNE, MS",2023-07-07,5,8,3
3630211768,"ACKLEY, IA","DORAVILLE, GA",2023-07-07,4,3,-1
1087563916,"CALVERT CITY, KY","EMORY GAP, TN",2023-07-07,6,4,-2
3630112867,"MAHRT (CCH), AL","DE RIDDER, LA",2023-07-07,0,1,1
3630102171,"ARBELA, MS","KERNERSVILLE, NC",2023-07-07,7,8,1
1087661340,"WYLIE, TX","CHARLOTTE, NC",2023-07-07,1,4,3
1087549158,"BARSTOW, CA","HARRISBURG, PA",2023-07-07,7,10,3
1087558262,"WARREN, MI","LAGRANGE, NL",2023-07-07,4,2,-2
3630142642,"DAVISVILLE, RI","LAFAYETTE, IN",2023-07-07,10,9,-1
1087550036,"AUSTELL, GA","CHICAGO, IL",2023-07-07,2,3,1
3630079572,"CALVERT, AL","INDIANA HARBOR, IN",2023-07-07,10,9,-1
3630141256,"AMERICUS, GA","BAYPORT, TX",2023-07-07,2,4,2
3630121264,"NIXON, GA","MCINTOSH, AL",2023-07-07,1,2,1
1087630894,"THOMASTON, IN","MONROE, MI",2023-07-07,10,8,-2
3630171235,"EVADALE, TX","BARTON, AL",2023-07-07,5,5,0
3630093356,"LOS ANGELES, CA","AUSTELL, GA",2023-07-07,5,6,1
1087625001,"NORFOLK, VA","CHICAGO, IL",2023-07-07,6,8,2
3630153619,"TROIS RIVIERES, PQ","ELIZABETHTOWN, KY",2023-07-07,10,8,-2
3630121824,"AUBURN, NY","CHEMUNG, NY",2023-07-07,3,6,3
3630114144,"MIAMI, FL","ATLANTA, GA",2023-07-07,5,7,2
3630107650,"SANDUSKY DOCK, OH","CROOKED CREEK MINE, PA",2023-07-07,6,6,0
1087591286,"VALDOSTA, GA","BURNSVILLE, MS",2023-07-07,7,9,2
1087540463,"DET JEFFERSON, MI","PEARLAND, TX",2023-07-07,11,8,-3
3630091485,"WINSTON-SALEM, NC","WHITE PIGEON, MI",2023-07-07,8,5,-3
3630137079,"WEIRTON, WV","FAIRLESS, PA",2023-07-07,7,10,3
3630153172,"FT DODGE, IA","MECHANICSBURG, PA",2023-07-07,4,4,0
1087636701,"HOUSTON, TX","MORRISVILLE, PA",2023-07-07,7,8,1
1087667029,"BALTIMORE DUNDALK M, MD","CHICAGO, IL",2023-07-07,1,3,2
3630098982,"ASHEVILLE, NC","HANNA, OH",2023-07-07,1,1,0
3630068246,"CHICAGO, IL","RUTHERFORD, PA",2023-07-07,1,4,3
3630159479,"ADDIS, LA","SOUTH ANDERSON, SC",2023-07-07,1,1,0
3630162383,"LACYMARK, FL","JUNCTION CITY, GA",2023-07-07,3,2,-1
3630070170,"DELTA, OH","PHOENIX, AZ",2023-07-07,12,9,-3
3630130491,"UNION BRIDGE, MD","DURHAM, NC",2023-07-07,2,2,0
1087610161,"MACEDONIA, OH","CRAWFORDSVILLE, IN",2023-07-07,4,6,2
3630115394,"RALEIGH, NC","ROBERTA, AL",2023-07-07,2,3,1
1087577428,"GATEWAY MINE, IL","WHEATFIELD, IN",2023-07-07,5,5,0
3630104270,"VENICE, IL","CARLISLE, PA",2023-07-02,-2,1,3
3628751613,"LAMBERTS POINT, VA","TOMS CREEK, VA",2023-07-07,5,6,1
3630219245,"KRANNERT, GA","FT WAYNE, IN",2023-07-07,9,10,1
1087689584,"CANNELTON (KNWA), WV","LAMBERTS POINT, VA",2023-07-07,-2,1,3
3630192443,"PRESCOTT, ON","WINSTON-SALEM, NC",2023-07-07,7,5,-2
3630109783,"LOUISVILLE, KY","LOUISVILLE, KY",2023-07-07,3,6,3
3630122781,"MERIDIAN, MS","CHARLOTTE, NC",2023-07-07,6,4,-2
3630206975,"MARSHALL, MN","DOUGHERTY, GA",2023-07-07,7,4,-3
1087689623,"CANNELTON (KNWA), WV","LAMBERTS POINT, VA",2023-07-07,3,2,-1
3630074946,"LOS ANGELES, CA","JACKSONVILLE, FL",2023-07-07,9,8,-1
3630084983,"STEVENSON, AL","SAVANNAH, GA",2023-07-07,5,8,3
1087559072,"VANSANT, VA","CLEVELAND, OH",2023-07-07,0,3,3
3630061715,"KANSAS CITY, MO","KANSAS CITY, MO",2023-07-07,5,6,1
3630184034,"PRENTISS, AB","LAFAYETTE, IN",2023-07-07,9,10,1
3630139657,"LEOLA, PA","CLEWISTON, FL",2023-07-07,13,10,-3
3630115522,"NEKOOSA, WI","FAIRBORN, OH",2023-07-07,7,7,0
1087608384,"TALLADEGA, AL","WAYNE, MI",2023-07-07,-2,1,3
3630188101,"PORT WILMINGTON, DE","WESTVACO, WY",2023-07-07,7,4,-3
1087694571,"DALLAS, TX","MORRISVILLE, PA",2023-07-07,8,10,2
3630074637,"CLEWISTON, FL","TYNER, TN",2023-07-07,9,9,0
3630123012,"BATH, NY","REYBOLD, DE",2023-07-07,4,5,1
3630102367,"EAST WARRENTON, GA","BRUNSWICK, GA",2023-07-07,7,8,1
3630075984,"MERIDIAN, MS","CHARLOTTE, NC",2023-07-07,5,8,3
3630068490,"CHICAGO, IL","COLUMBUS, OH",2023-07-07,4,4,0
3630137134,"CHASE, AL","FORMOSA, TX",2023-07-07,11,10,-1
3630199754,"CEDAR RAPIDS, IA","CITY POINT, FL",2023-07-07,9,7,-2
3630197184,"SANDERSVILLE, GA","STEVENS POINT, WI",2023-07-07,5,2,-3
3630073097,"PRATTVILLE, AL","EIGHTY FOUR, PA",2023-07-07,3,6,3
3630093746,"MEMPHIS, TN","CHARLOTTE, NC",2023-07-07,12,10,-2
3630122498,"HOUSTON, TX","PEDRICKTOWN, NJ",2023-07-07,5,3,-2
3628835386,"CHARLOTTE, NC","WHITE PIGEON, MI",2023-07-07,6,4,-2
3630142139,"THOMASTON, IN","MONROE, MI",2023-07-07,2,2,0
1087567821,"CHESAPEAKE, VA","MOUNDSVILLE, WV",2023-07-07,2,4,2
3630095463,"GATEWAY MINE, IL","WHEATFIELD, IN",2023-07-07,9,9,0
3630203618,"WARRENTON, OH","SPARTA, WI",2023-07-07,9,6,-3
3630110831,"CHICAGO ENGLEW TV, IL","CHICAGO ENGLEW TV, IL",2023-07-07,8,7,-1
3630189123,"ELKHART, IN","SELMA, MO",2023-07-07,7,9,2
3630189678,"COLUMBIA CITY, IN","ST LOUIS, MO",2023-07-07,12,10,-2
1087675365,"SELKIRK, NY","LAFAYETTE, IN",2023-07-07,9,10,1
3630061016,"CHICAGO, IL","CINCINNATI, OH",2023-07-07,4,4,0
3630189961,"ANDERSONVILLE, GA","SAVANNAH, GA",2023-07-07,5,2,-3
3630181581,"SELKIRK, NY","LAFAYETTE, IN",2023-07-07,7,8,1
1087715319,"LADSON, SC","EL MIRAGE, AZ",2023-07-07,1,3,2
3630048717,"CICERO, IL","BETHINTERMODAL, PA",2023-07-07,1,2,1
3630078128,"WARREN, MI","LAGRANGE, NL",2023-07-02,10,9,-1
3628723084,"LAMBERTS POINT, VA","TOMS CREEK, VA",2023-07-07,7,5,-2
3630104791,"STOCKTON IMF, CA","JACKSONVILLE, FL",2023-07-07,5,2,-3
1087655349,"DETROIT, MI","LOS ANGELES, CA",2023-07-07,10,7,-3
1087653193,"BRUNSWICK, GA","ARMSTRONG, GA",2023-07-07,5,3,-2
1087613088,"MALLARD, AL","DECATUR, AL",2023-07-07,-1,1,2
1087638101,"DECATUR, IL","HOMER, IL",2023-07-07,5,5,0
1087549865,"LOGISTICS PARK KANS, KS","HARRISBURG, PA",2023-07-07,8,5,-3
3630113732,"CINCINNATI, OH","CHICAGO, IL",2023-07-07,2,2,0
3630068385,"CHICAGO, IL","CROXTON, NJ",2023-07-07,-1,1,2
1087565528,"MEHOOPANY, PA","PHILADELPHIA, PA",2023-07-07,12,9,-3
3630065337,"SLCIT, UT","GREENSBORO, NC",2023-07-07,5,4,-1
1087567423,"JACKSONVILLE, FL","VOLTZ, MO",2023-07-07,2,4,2
3630063602,"TOLEDO AIRLINE, OH","TOLEDO AIRLINE, OH",2023-07-07,8,8,0
1087599103,"LOS ANGELES, CA","CROXTON, NJ",2023-07-07,7,6,-1
1087628724,"SARNIA, ON","TOLEDO, OH",2023-07-07,8,5,-3
3630075269,"BROADWAY, VA","LINVILLE, VA",2023-07-07,8,8,0
3630183949,"NORFOLK INTERNATION, VA","LANDERS, IL",2023-07-07,6,8,2
3630151049,"DECATUR, IL","HOMER, IL",2023-07-07,-1,2,3
3630052295,"BLUFFTON, IN","SELMA, NC",2023-07-07,6,5,-1
3630059734,"CALVERT, AL","GREENVILLE, SC",2023-07-07,1,3,2
1087700568,"POSTELL, GA","ODUM, GA",2023-07-07,2,2,0
3630207191,"WHITE RIVER JCT, VT","LUDLOWVILLE (ITHR), NY",2023-07-07,9,6,-3
1087664966,"RUTHERFORD, PA","TITUSVILLE, FL",2023-07-07,12,10,-2
1087536951,"CROXTON, NJ","ATLANTA, GA",2023-07-07,3,3,0
3630144563,"LATHROP, CA","MIAMI, FL",2023-07-07,5,2,-3
3630199209,"TITUSVILLE, FL","CHICAGO 47TH ST TV, IL",2023-07-07,4,7,3
3630151196,"DECATUR, IL","HOMER, IL",2023-07-07,9,7,-2
3630186808,"TEXAS CITY, TX","KINGSPORT, TN",2023-07-07,12,9,-3
1087556480,"DODGE CITY, MI","LIVERNOIS, MI",2023-07-07,7,7,0
3630069373,"ROSSER, GA","BARNESVILLE, GA",2023-07-07,4,6,2
1087659474,"OAKWOOD, MI","GARY, IN",2023-07-07,7,7,0
3630206983,"MARSHALL, MN","DOUGHERTY, GA",2023-07-07,0,3,3
1087532478,"LOS ANGELES, CA","RUTHERFORD, PA",2023-07-07,9,8,-1
3630118960,"MORGANTON, NC","HAMILTON, ON",2023-07-07,7,10,3
3630092952,"WAYNESBURG, PA","BETHLEHEM, PA",2023-07-07,8,6,-2
3630079093,"WINSTON-SALEM, NC","CLAYPOOL, IN",2023-07-07,5,2,-3
3630164131,"NORTH CHARLESTON, SC","GREENVILLE, SC",2023-07-07,3,2,-1
3630113758,"CINCINNATI, OH","CINCINNATI, OH",2023-07-07,3,1,-2
3630210306,"COLQUITT, GA","LITTLE ROCK, AR",2023-07-07,1,2,1
3630126963,"SLCIT, UT","HARRISBURG, PA",2023-07-07,2,1,-1
3630132867,"SELKIRK, NY","BUFFALO, NY",2023-07-07,6,5,-1
1087568877,"BOWDEN YARD, FL","PRINCETON, IN",2023-07-07,9,6,-3
3630161997,"STAPLETON, GA","WAUSAU, WI",2023-07-07,5,2,-3
1087540803,"HARRISBURG, PA","CHICAGO, IL",2023-07-06,4,4,0
3629821411,"SURRENCY, GA","ANDERSON (ICRK), IN",2023-07-07,9,6,-3
3630086503,"ST LOUIS, MO","PARACHUTE, CO",2023-07-07,4,6,2
3630169018,"LATC, CA","HARRISBURG, PA",2023-07-07,7,10,3
1087589271,"CLEVELAND, OH","BURNS HARBOR, IN",2023-07-07,3,5,2
1087533903,"CROXTON, NJ","LOS ANGELES, CA",2023-07-07,2,5,3
3630198122,"EAGLE MILLS, AR","MEMPHIS, TN",2023-07-07,2,4,2
3630080604,"HYCO, NC","BAILEY MINE, PA",2023-07-07,5,8,3
1087533377,"LOS ANGELES, CA","RUTHERFORD, PA",2023-07-07,2,3,1
1087629063,"AMERICUS, GA","BAYPORT, TX",2023-07-07,4,6,2
3630203757,"LAMBERTS POINT, VA","TOMS CREEK, VA",2023-07-07,1,1,0
3630108517,"LOS ANGELES, CA","JACKSONVILLE, FL",2023-07-07,6,8,2
3630068830,"CHARLOTTE INTER, NC","CHARLOTTE INTER, NC",2023-07-07,5,4,-1
3630057326,"MAHRT (CCH), AL","PORT WENTWORTH, GA",2023-07-07,-1,2,3
3630139055,"ORANGE, TX","YEATTS, VA",2023-07-03,8,9,1
3628888583,"WINSTON-SALEM, NC","WHITE PIGEON, MI",2023-07-07,3,6,3
3630124165,"CAMP HILL, PA","ARKANSAS CITY, KS",2023-07-07,6,6,0
3630108389,"VALDOSTA, GA","BURNSVILLE, MS",2023-07-07,12,9,-3
3630181531,"SELKIRK, NY","LAFAYETTE, IN",2023-07-07,6,8,2
1087622118,"HUNTSVILLE, AL","GARDEN CITY, GA",2023-07-07,10,7,-3
3630077554,"LAFAYETTE, IN","LAFAYETTE, IN",2023-07-07,6,3,-3
3630212081,"WINSTON-SALEM, NC","HOBBS, IN",2023-07-07,4,5,1
1087567415,"LOS ANGELES, CA","PITTSBURGH, PA",2023-07-07,3,4,1
3630207183,"WHITE RIVER JCT, VT","LUDLOWVILLE (ITHR), NY",2023-07-07,4,2,-2
1087664128,"BEAVERDAM, OH","CHALMETTE, LA",2023-07-07,11,10,-1
1087577826,"GATEWAY MINE, IL","WHEATFIELD, IN",2023-07-07,6,5,-1
3630086888,"SHELBURNE, VT","LUDLOWVILLE (ITHR), NY",2023-07-07,1,3,2
1087591309,"VALDOSTA, GA","BURNSVILLE, MS",2023-07-07,2,2,0
1087634107,"SHARONVILLE, OH","SHARONVILLE, OH",2023-07-07,3,5,2
3630094352,"CLAY, DE","LAFAYETTE, IN",2023-07-07,5,5,0
1087624649,"WEIRTON, WV","FAIRLESS, PA",2023-07-07,9,7,-2
3630068123,"LOS ANGELES, CA","CROXTON, NJ",2023-07-07,7,9,2
3630060808,"CHICAGO, IL","CINCINNATI, OH",2023-07-07,11,8,-3
3630197419,"ALLEMANIA, LA","KINGSPORT, TN",2023-07-07,8,10,2
1087536113,"LEIPSIC, OH","LOUISVILLE, KY",2023-07-07,8,9,1
3630213859,"HANNA, OH","ROXANA, IL",2023-07-07,-1,2,3
1087614490,"MALLARD, AL","ATTALLA, AL",2023-07-07,0,3,3
3630138512,"CLEARING CHGO, IL","LEWISTOWN (JVRR), PA",2023-07-07,10,8,-2
3630076168,"MERIDIAN, MS","AUSTELL, GA",2023-07-07,10,8,-2
1087591723,"ZANESVILLE, OH","WEDRON, IL",2023-07-07,9,9,0
3630115718,"STEELTON, PA","LACASSINE, LA",2023-07-07,2,2,0
1087636913,"DECATUR, IL","HOMER, IL",2023-07-07,3,6,3
3630080426,"HYCO, NC","BAILEY MINE, PA",2023-07-07,8,10,2
3630187579,"LAFAYETTE, IN","VERNON, CA",2023-07-07,4,7,3
3630054572,"CAROL, IN","FRANCISCO, IN",2023-07-07,4,5,1
3630068961,"LOS ANGELES, CA","BALTIMORE, MD",2023-07-07,4,7,3
3630118067,"CRESSON, PA","CRAB ORCHARD, TN",2023-07-07,3,2,-1
1087529603,"LONG BEACH E PIER, CA","CLEVELAND, OH",2023-07-07,4,2,-2
3630175124,"DALLAS, TX","CROXTON, NJ",2023-07-07,6,6,0
1087612422,"SHELBY, NC","CHARLOTTE, NC",2023-07-07,6,9,3
1087637684,"CLEVELAND, OH","LONG BEACH E PIER, CA",2023-07-07,4,1,-3
1087687566,"LOS ANGELES, CA","PITTSBURGH, PA",2023-07-07,6,4,-2
3630087339,"SHARON, PA","HAMILTON, ON",2023-07-02,5,2,-3
3628671083,"CHARLOTTE, NC","WHITE PIGEON, MI",2023-07-07,11,10,-1
3630124539,"NEPHTON, ON","RICHMOND, IN",2023-07-07,0,1,1
3630142244,"MELVINDALE, MI","KANSAS CITY, MO",2023-07-07,7,7,0
1087682118,"MORRISVILLE, PA","DALLAS, TX",2023-07-07,8,5,-3
1087570434,"NEW ORLEANS, LA","NEW ORLEANS, LA",2023-07-07,12,10,-2
1087549920,"LOS ANGELES, CA","CROXTON, NJ",2023-07-03,9,6,-3
3629125784,"SANDUSKY DOCK, OH","CROOKED CREEK MINE, PA",2023-07-07,3,1,-2
3630128923,"DANIELSON, CT","UNIONTOWN, AL",2023-07-07,3,5,2
1087563071,"MIDDLETOWN, OH","WAYNE, MI",2023-07-07,2,4,2
3630194089,"TITUSVILLE, FL","SAN BERNARDINO, CA",2023-07-07,10,10,0
1087703184,"ROBERTS BANK, BC","COLUMBUS, OH",2023-07-07,10,7,-3
3630170001,"LADSON, SC","CLYATTVILLE, GA",2023-07-07,3,6,3
3630209004,"MAHANOY CITY, PA","BILLINGS, MT",2023-07-07,-1,1,2
3630131421,"DALLAS, TX","HARRISBURG, PA",2023-07-07,8,9,1
3630075219,"SAN BERNARDINO, CA","CHARLOTTE, NC",2023-07-07,6,5,-1
3630138889,"GUELPH, ON","SELMA, NC",2023-07-07,6,3,-3
3630122503,"HOUSTON, TX","PEDRICKTOWN, NJ",2023-07-07,8,7,-1
1087685849,"KINGSPORT, TN","LONGVIEW, TX",2023-07-07,4,4,0
1087535565,"RUTHERFORD, PA","ROSSVILLE, TN",2023-07-07,5,4,-1
1087598911,"EAST CHICAGO, IN","CHARLESTON, SC",2023-07-07,9,7,-2
3630097481,"NORFOLK, VA","NORFOLK, VA",2023-07-07,7,5,-2
3630157574,"PAINESVILLE, OH","CONGO, WV",2023-07-07,-2,1,3
1087653559,"LACYMARK, FL","JUNCTION CITY, GA",2023-07-07,1,4,3
3630191099,"PUERTA MEXICO, EM","AUSTELL, GA",2023-07-07,11,10,-1
1087638729,"SCHENECTADY, NY","NORTHUMBERLAND UCIR, PA",2023-07-07,-1,1,2
1087625027,"APPLIANCE PARK, KY","GARDEN CITY, GA",2023-07-07,1,2,1
3630079687,"LATC, CA","HARRISBURG, PA",2023-07-07,3,3,0
3630152469,"LAMBERTS POINT, VA","WILLIAMSON YARD, WV",2023-07-07,13,10,-3
1087612032,"MALLARD, AL","DECATUR, AL",2023-07-03,1,1,0
3628888575,"WINSTON-SALEM, NC","WHITE PIGEON, MI",2023-07-07,8,9,1
3630158148,"BURNS HARBOR, IN","BURNS HARBOR, IN",2023-07-07,8,8,0
3630092821,"RINCON, GA","BROOKLAWN, LA",2023-07-07,8,7,-1
1087614961,"NEW ORLEANS, LA","PENNINGTON, AL",2023-07-07,0,1,1
1087629013,"MAHRT (CCH), AL","PORT WENTWORTH, GA",2023-07-07,5,7,2
3630126824,"EDGERTON, IN","KINGS CREEK (DCR), MD",2023-07-07,9,7,-2
3630115598,"STEELTON, PA","LACASSINE, LA",2023-07-07,7,4,-3
3630080298,"HYCO, NC","BAILEY MINE, PA",2023-07-07,3,5,2
3630049349,"PORT WENTWORTH, GA","STUARTS DRAFT, VA",2023-07-07,9,9,0
1087539543,"LOS ANGELES, CA","HARRISBURG, PA",2023-07-07,2,1,-1
3630126329,"CHATTANOOGA, TN","WEST LAKE CHARLES, LA",2023-07-07,2,5,3
1087688172,"BOYKINS, VA","WILLIAMSPORT, PA",2023-07-06,11,8,-3
3629867394,"LAMBERTS POINT, VA","TOMS CREEK, VA",2023-07-07,4,4,0
3630148559,"DECATUR, IL","DECATUR, IL",2023-07-07,9,6,-3
3630067070,"BIRMINGHAM, AL","FAIRFIELD, AL",2023-07-07,2,5,3
3630053259,"MELVINDALE, MI","KANSAS CITY, MO",2023-07-07,8,6,-2
3630145569,"BIRMINGHAM, MO","DETROIT DEARBORN, MI",2023-07-07,10,9,-1
3630063220,"LAMBERTS POINT, VA","WILLIAMSON YARD, WV",2023-07-07,10,8,-2
1087585104,"ANNVILLE, PA","FELTON (DCR), DE",2023-07-07,2,1,-1
3630196219,"DECATUR, AL","WYTHEVILLE, VA",2023-07-07,4,7,3
3630110483,"DALTON, GA","NEAL, WV",2023-07-07,7,9,2
1087551228,"BUFFALO, NY","CHICAGO ENGLEW TV, IL",2023-07-07,4,6,2
3630073217,"CLINTON, IA","VILLA RICA, GA",2023-07-07,4,2,-2
1087533880,"REYBOLD, DE","YULEE, FL",2023-07-07,0,3,3
1087613923,"MARTINSBURG, WV","LEETSDALE, PA",2023-07-07,6,5,-1
3630189424,"BIRMINGHAM, MO","CHICAGO HEIGHTS, IL",2023-07-07,4,2,-2
3630071118,"BLUE ISLAND, IL","IRVIN, PA",2023-07-07,4,4,0
3630178863,"PORT ARTHUR, TX","SELMA, NC",2023-07-07,3,6,3
3630145527,"ELDON, TX","MONTGOMERY, NY",2023-07-07,7,7,0
3630188428,"TACOMA EXPORT, WA","CINCINNATI, OH",2023-07-07,8,7,-1
3630189880,"GOOD SPRING, PA","HANNA, OH",2023-07-07,-2,1,3
1087576294,"WADSWORTH, TX","LENOIR, NC",2023-07-07,3,5,2
3630099718,"BOYCE, TN","GRAMERCY, LA",2023-07-07,5,7,2
3630133295,"BUFFALO, NY","BUFFALO, NY",2023-07-07,2,2,0
1087677927,"BETHINTERMODAL, PA","KANSAS CITY, MO",2023-07-07,4,1,-3
3630080133,"HYCO, NC","BAILEY MINE, PA",2023-07-07,4,7,3
3630087494,"KANSAS CITY, MO","MELVINDALE, MI",2023-07-07,5,8,3
3630149270,"HAMPTON, GA","ANDERSON, TN",2023-07-07,6,8,2
1087681714,"HUNTSVILLE, AL","HUNTSVILLE, AL",2023-07-07,11,9,-2
3630065696,"MONROE, MI","CHICAGO, IL",2023-07-07,7,8,1
3630157566,"DETROIT DEARBORN, MI","BIRMINGHAM, MO",2023-07-07,10,7,-3
3630048759,"CICERO, IL","NORFOLK, VA",2023-07-07,3,6,3
3630198570,"MERIDIAN, MS","MCDONOUGH, GA",2023-07-07,3,3,0
1087710199,"HARRISBURG, PA","BARSTOW, CA",2023-07-07,4,1,-3
1087533539,"ST LOUIS, MO","RUTHERFORD, PA",2023-07-07,7,4,-3
1087530256,"MACON, GA","MACON, GA",2023-07-02,11,8,-3
3628723571,"LAMBERTS POINT, VA","TOMS CREEK, VA",2023-07-07,9,9,0
3630142189,"THOMASTON, IN","MONROE, MI",2023-07-07,6,8,2
1087573791,"TALLADEGA, AL","PINE, IN",2023-07-07,5,6,1
3630171277,"YOUNGSTOWN, OH","NORTH BERGEN, NJ",2023-07-07,7,10,3
3630110491,"SAYRE, PA","FARMERS VALLEY, PA",2023-07-07,12,10,-2
1087625239,"MCDONOUGH, GA","PRENTISS, AB",2023-07-07,6,5,-1
3630120218,"MACMILLAN, AL","CLEVELAND, TN",2023-07-07,5,7,2
3630187626,"LOGISTICS PARK CHIC, IL","CHICAGO, IL",2023-07-07,4,2,-2
1087644770,"PT EVERGLADES, FL","BLAIR, NE",2023-07-07,8,6,-2
3630052041,"BLUFFTON, IN","SELMA, NC",2023-07-07,2,1,-1
3630187163,"DECATUR, AL","DECATUR, AL",2023-07-03,-2,1,3
3628888761,"WINSTON-SALEM, NC","WHITE PIGEON, MI",2023-07-07,-2,1,3
3630186531,"MIDDLE RIVER, MD","PLAQUEMINE, LA",2023-07-07,11,10,-1
1087616531,"BURNS HARBOR, IN","BURNS HARBOR, IN",2023-07-07,6,5,-1
1087629665,"AUSTELL, GA","GARDEN CITY, GA",2023-07-07,-2,1,3
3630185878,"GRANITE CITY, IL","GRANITE CITY, IL",2023-07-07,6,5,-1
3630199885,"ROBERTS BANK, BC","CLEVELAND, OH",2023-07-07,11,9,-2
3630111358,"WHITESTONE, SC","CHANNELVIEW, TX",2023-07-07,2,5,3
1087578173,"GATEWAY MINE, IL","WHEATFIELD, IN",2023-07-04,3,3,0
3629137676,"SANDUSKY DOCK, OH","CROOKED CREEK MINE, PA",2023-07-07,2,4,2
1087685865,"KINGSPORT, TN","LONGVIEW, TX",2023-07-07,8,5,-3
3630218118,"PORTLAND, OR","AUSTELL, GA",2023-07-07,-1,2,3
3630136887,"LAMBERTS POINT, VA","WILLIAMSON YARD, WV",2023-07-07,1,1,0
1087564310,"CALVERT CITY, KY","EMORY GAP, TN",2023-07-07,9,7,-2
3630195297,"NORFOLK INTERNATION, VA","APPLIANCE PARK, KY",2023-07-07,-1,2,3
3630197778,"ROANOKE, IN","DIXIANA, SC",2023-07-07,9,8,-1
1087702471,"BETHINTERMODAL, PA","CHICAGO, IL",2023-07-07,2,4,2
1087652943,"BLANCHESTER, OH","THOMASVILLE, AL",2023-07-07,3,4,1
1087567407,"LOS ANGELES, CA","RUTHERFORD, PA",2023-07-07,11,8,-3
1087645213,"LUDLOWVILLE (ITHR), NY","SHELBURNE, VT",2023-07-07,1,4,3
3630172338,"BELLEVUE, OH","ATTALLA, AL",2023-07-07,13,10,-3
3630065125,"LOS ANGELES, CA","MORRISVILLE, PA",2023-07-07,9,6,-3
1087615771,"DARROW, IL","LAFAYETTE, IN",2023-07-07,4,4,0
1087523665,"BLUFFTON, IN","SELMA, NC",2023-07-07,6,3,-3
1087607192,"HAMILTON, ON","MELVINDALE, MI",2023-07-07,7,6,-1
3630132817,"SELKIRK, NY","BUFFALO, NY",2023-07-07,5,7,2
3630146696,"ARMOREL, AR","SAVANNAH, GA",2023-07-02,5,8,3
3628755730,"CAROL, IN","FRANCISCO, IN",2023-07-07,4,2,-2
1087551121,"BUFFALO, NY","CHICAGO ENGLEW TV, IL",2023-07-07,10,7,-3
3630118562,"CRESSON, PA","CLEVELAND, OH",2023-07-07,11,8,-3
3630197689,"CRAWFORDSVILLE, IN","PRINCETON, IN",2023-07-07,-2,1,3
1087666691,"NEW ORLEANS, LA","NEW ORLEANS, LA",2023-07-07,10,9,-1
3630178708,"PORT ARTHUR, TX","ELIZABETH, NJ",2023-07-07,9,8,-1
3630188208,"MACMILLAN, AL","LYNCHBURG, VA",2023-07-07,2,5,3
1087560227,"LOS ANGELES, CA","AUSTELL, GA",2023-07-07,5,4,-1
1087541370,"KANSAS CITY, MO","AUSTELL, GA",2023-07-07,0,2,2
3630158025,"BURNS HARBOR, IN","BURNS HARBOR, IN",2023-07-07,3,3,0
3630218029,"LATHROP, CA","HARRISBURG, PA",2023-07-07,3,4,1
3630111332,"EAST CHICAGO, IN","TAMPA, FL",2023-07-07,7,5,-2
3630138732,"WINTER HAVEN, FL","EATONTON, GA",2023-07-07,4,4,0
3630217756,"LOS ANGELES, CA","CHARLOTTE, NC",2023-07-07,8,7,-1
3630196099,"SWANTON, VT","DECATUR, IL",2023-07-07,10,10,0
1087631599,"WYLIE, TX","ATLANTA, GA",2023-07-07,2,4,2
3630121052,"TOLEDO, OH","MIDDLETOWN, OH",2023-07-07,7,9,2
1087585609,"EAST WARRENTON, GA","BRUNSWICK, GA",2023-07-07,4,3,-1
3630092407,"WAYNESBURG, PA","BETHLEHEM, PA",2023-07-07,3,3,0
3630191112,"FRONT ROYAL, VA","NORFOLK INTERNATION, VA",2023-07-07,11,8,-3
3630172142,"NEW ORLEANS, LA","BIRMINGHAM, AL",2023-07-07,8,5,-3
1087701637,"BAYOU PIERRE, LA","DECATUR, AL",2023-07-07,4,6,2
3630197223,"WYLIE, TX","TITUSVILLE, FL",2023-07-07,8,5,-3
3630049836,"TROUTVILLE, VA","CEDARVILLE, VA",2023-07-07,10,7,-3
3630121955,"AUBURNDALE, FL","JACKSONVILLE, FL",2023-07-07,12,10,-2
3630051728,"LEMOYNE, AL","ROBERTA, AL",2023-07-07,9,7,-2
1087694204,"SLCIT, UT","HARRISBURG, PA",2023-07-07,4,4,0
1087702196,"TOLEDO AIRLINE, OH","CROXTON, NJ",2023-07-07,3,1,-2
3630212269,"MILLSDALE, IL","CAMBRIDGE, OH",2023-07-07,7,10,3
3630192972,"VERTAGREEN, AL","SILVER SPRINGS, NY",2023-07-07,8,10,2
1087647231,"AUSTELL, GA","GARDEN CITY, GA",2023-07-07,5,7,2
3630127537,"TOLEDO, OH","INDIANA HARBOR, IN",2023-07-07,5,2,-3
3630116188,"DUNKIRK, IN","OTTAWA, IL",2023-07-05,0,1,1
1087004904,"SURRENCY, GA","ANDERSON (ICRK), IN",2023-07-07,6,4,-2
3630153114,"HAVERHILL, OH","GALLIPOLIS, WV",2023-07-07,6,3,-3
3630071451,"SAN BERNARDINO, CA","AUSTELL, GA",2023-07-07,-1,1,2
3630048767,"CICERO, IL","NORFOLK, VA",2023-07-07,5,8,3
3630181890,"SELKIRK, NY","LAFAYETTE, IN",2023-07-07,4,1,-3
3630183729,"NORFOLK INTERNATION, VA","LANDERS, IL",2023-07-07,3,5,2
1087701263,"SCHENECTADY, NY","TAYLOR, PA",2023-07-07,4,3,-1
3630219334,"BLOOMSBURG, PA","FREEPORT, TX",2023-07-07,4,6,2
1087591943,"MORRISVILLE, PA","CHICAGO, IL",2023-07-07,9,7,-2
1087644445,"AUSTELL, GA","SEATTLE, WA",2023-07-07,5,8,3
3630182561,"SANDERSVILLE, GA","WESTVACO, WY",2023-07-07,6,5,-1
3630202890,"LAMBERTS POINT, VA","TOMS CREEK, VA",2023-07-07,10,10,0
1087604005,"MORGANTON, NC","HAMILTON, ON",2023-07-07,3,4,1
3630068149,"CHICAGO, IL","CROXTON, NJ",2023-07-07,1,4,3
3630182032,"MIDWEST PORTAGE, IN","GARY, IN",2023-07-07,7,4,-3
1087694856,"TEMISCAMING, PQ","PEPPER, VA",2023-07-07,1,1,0
3630183915,"NORFOLK INTERNATION, VA","LANDERS, IL",2023-07-07,5,8,3
3630212934,"WINSTON-SALEM, NC","HOBBS, IN",2023-07-07,6,9,3
3630049747,"TROUTVILLE, VA","BRISTOL, VA",2023-07-07,-1,1,2
3630184490,"CLAY, DE","FOSTORIA, OH",2023-07-07,3,3,0
3630117320,"COSGROVE, MO","CAMBRIDGE, OH",2023-07-07,4,1,-3
3630060159,"KANSAS CITY, MO","KANSAS CITY, MO",2023-07-07,8,7,-1
1087667118,"BALTIMORE DUNDALK M, MD","CHICAGO, IL",2023-07-07,6,4,-2
3630084658,"RUBY, GA","JACKSONVILLE, FL",2023-07-07,5,2,-3
1087533830,"AUSTELL, GA","KANSAS CITY, MO",2023-07-07,6,9,3
3630085751,"BOWDEN YARD, FL","ROSSVILLE, TN",2023-07-07,2,1,-1
3630062274,"STEVENSON, AL","WICKHAM SPUR, IA",2023-07-07,3,1,-2
3630093526,"ELIZABETHTOWN, PA","KEOKUK, IA",2023-07-02,3,1,-2
3628672110,"LAMBERTS POINT, VA","TOMS CREEK, VA",2023-07-07,10,10,0
3630127634,"TOLEDO, OH","INDIANA HARBOR, IN",2023-07-07,6,5,-1
3630067486,"GEORGETOWN, KY","ORILLIA, WA",2023-07-07,5,8,3
3630157346,"WINSTON-SALEM, NC","STRANG, TX",2023-07-02,8,10,2
3628723602,"LAMBERTS POINT, VA","TOMS CREEK, VA",2023-07-07,6,4,-2
3630092423,"WAYNESBURG, PA","BETHLEHEM, PA",2023-07-07,4,3,-1
1087575971,"MEMPHIS, TN","JACKSONVILLE, FL",2023-07-07,3,2,-1
3630141793,"KANSAS CITY, MO","MELVINDALE, MI",2023-07-07,11,9,-2
1087647299,"IEIT, CA","HARRISBURG, PA",2023-07-07,3,5,2
3630132257,"LAMBERTS POINT, VA","WILLIAMSON YARD, WV",2023-07-07,8,9,1
3630138237,"LAMBERTS POINT, VA","WILLIAMSON YARD, WV",2023-07-07,7,10,3
1087520308,"VOLTZ, MO","GCT BAYONNE, NJ",2023-07-07,1,4,3
3630126913,"DOVER, OH","TOLEDO, OH",2023-07-07,5,5,0
3630098958,"ASHEVILLE, NC","SCIO, OH",2023-07-07,6,7,1
3630061707,"KANSAS CITY, MO","KANSAS CITY, MO",2023-07-07,2,2,0
3630203985,"MELVINDALE, MI","KANSAS CITY, MO",2023-07-07,6,4,-2
1087653266,"LACYMARK, FL","JUNCTION CITY, GA",2023-07-07,1,2,1
3630152388,"EAST ST LOUIS, IL","BLUFFTON, IN",2023-07-07,5,2,-3
1087663091,"YOUNGSTOWN, OH","NORTH BERGEN, NJ",2023-07-07,8,10,2
1087553343,"SAN BERNARDINO, CA","AUSTELL, GA",2023-07-07,8,7,-1
3630117760,"LEWISTOWN, PA","FREEPORT, TX",2023-07-07,2,1,-1
1087675975,"SANDERSVILLE, GA","ALCHEM, WY",2023-07-07,7,5,-2
3630143737,"BAYARD, FL","MODESTO, CA",2023-07-07,3,2,-1
3630188119,"PORT WILMINGTON, DE","WESTVACO, WY",2023-07-07,0,3,3
3630092520,"MELVINDALE, MI","KANSAS CITY, MO",2023-07-07,8,5,-3
1087638169,"UNION LANDING SIDIN, OH","READING, PA",2023-07-07,9,9,0
3630104775,"PETERSBURG, VA","WOOD RIVER, IL",2023-07-07,2,2,0
3630060395,"KANSAS CITY, MO","KANSAS CITY, MO",2023-07-07,1,2,1
3630178025,"PRINCETON, IN","CRAWFORDSVILLE, IN",2023-07-07,9,7,-2
3630148402,"DECATUR, IL","DECATUR, IL",2023-07-07,8,9,1
3630203668,"LAMBERTS POINT, VA","TOMS CREEK, VA",2023-07-07,6,6,0
3630065557,"DECATUR, IL","CAREY, OH",2023-07-07,9,9,0
3630093005,"WAYNESBURG, PA","BETHLEHEM, PA",2023-07-07,2,1,-1
3630074564,"WEST HAZLETON, PA","NORTH VALLIANT, OK",2023-07-07,0,2,2
3630127587,"TOLEDO, OH","INDIANA HARBOR, IN",2023-07-07,6,7,1
1087676044,"MIDWEST PORTAGE, IN","GARY, IN",2023-07-07,4,6,2
3630197396,"LOS ANGELES, CA","CROXTON, NJ",2023-07-07,7,8,1
1087579632,"ERIE, PA","JERSEY, TN",2023-07-07,6,3,-3
1087565552,"RUTHERFORD, PA","JACKSONVILLE, FL",2023-07-07,8,6,-2
1087600019,"MAPLE HEIGHTS, OH","NORFOLK INTERNATION, VA",2023-07-04,5,7,2
3629143635,"SANDUSKY DOCK, OH","CROOKED CREEK MINE, PA",2023-07-07,8,6,-2
1087686667,"RIVER ROUGE, MI","LIVERNOIS, MI",2023-07-07,7,10,3
1087576919,"CLAY, DE","DELTA, OH",2023-07-07,5,3,-2
3630181599,"SELKIRK, NY","LAFAYETTE, IN",2023-07-07,11,8,-3
3630203024,"LAMBERTS POINT, VA","TOMS CREEK, VA",2023-07-07,9,7,-2
3630187113,"DECATUR, AL","DECATUR, AL",2023-07-07,6,5,-1
1087643384,"LEIPSIC, OH","CHOCOLATE BAYOU, TX",2023-07-07,6,6,0
1087605784,"BURNS HARBOR, IN","BRISTOL, PA",2023-07-07,4,3,-1
1087561825,"CALVERT, AL","INDIANA HARBOR, IN",2023-07-07,-1,1,2
3630206137,"GREENVILLE, NJ","WEST POINT, VA",2023-07-07,9,6,-3
3630197980,"LEE, GA","RANKIN, MS",2023-07-07,-1,2,3
3630107040,"SANDUSKY DOCK, OH","CROOKED CREEK MINE, PA",2023-07-07,-1,1,2
3630187846,"MIAMI, FL","JACKSONVILLE, FL",2023-07-07,5,8,3
3630128915,"DELTA, OH","SALEM, VA",2023-07-07,2,5,3
3630212984,"WINSTON-SALEM, NC","HOBBS, IN",2023-07-07,3,6,3
3630060117,"KANSAS CITY, MO","KANSAS CITY, MO",2023-07-07,-2,1,3
1087614408,"WYLIE, TX","ATLANTA, GA",2023-07-07,1,2,1
3630135718,"WAPAKONETA, OH","CINCINNATI, OH",2023-07-07,7,4,-3
1087550565,"CHICAGO 47TH ST TV, IL","CHICAGO 47TH ST TV, IL",2023-07-07,8,10,2
3630074263,"LOS ANGELES, CA","AUSTELL, GA",2023-07-07,10,9,-1
1087639026,"DECATUR, IL","HOMER, IL",2023-07-07,9,9,0
3630064103,"LOS ANGELES, CA","CROXTON, NJ",2023-07-07,11,10,-1
1087538783,"MORRISVILLE, PA","DALLAS, TX",2023-07-07,8,8,0
3630052651,"BLUFFTON, IN","SELMA, NC",2023-07-04,1,3,2
3629134173,"SANDUSKY DOCK, OH","CROOKED CREEK MINE, PA",2023-07-07,9,8,-1
3630117998,"SAINT JOHN, NB","MACON, GA",2023-07-07,5,2,-3
3630121248,"BRITTAIN, OH","WEVER, IA",2023-07-07,2,4,2
3630061155,"CHICAGO, IL","GEORGETOWN, KY",2023-07-07,2,5,3
3630206991,"MARSHALL, MN","LAKEVILLE, NY",2023-07-07,5,3,-2
3630131984,"NIAGARA FALLS, NY","PERRYMAN, MD",2023-07-07,2,2,0
1087713854,"AUGUSTA, GA","DONORA, PA",2023-07-07,5,7,2
3630141078,"ECORSE, MI","BESSEMER, PA",2023-07-07,4,6,2
3630179746,"RUEBEL, MN","CHICAGO, IL",2023-07-07,0,3,3
3630194754,"FARMERS VALLEY, PA","WOODS CROSS, UT",2023-07-07,12,10,-2
3630186913,"NORTH CHARLESTON, SC","FOREST PARK, GA",2023-07-07,1,2,1
3630159623,"NEW ORLEANS, LA","RURAL HALL (YVRR), NC",2023-07-07,4,3,-1
3630108614,"CHARLESTON, SC","MOSSVILLE, LA",2023-07-07,10,9,-1
1087616002,"DARROW, IL","LAFAYETTE, IN",2023-07-07,9,9,0
1087655137,"FRONT ROYAL, VA","PORTSMOUTH APMT, VA",2023-07-07,6,3,-3
3630190792,"CAREY, OH","MT HOLLY SPRINGS, PA",2023-07-07,4,6,2
1087677969,"BETHINTERMODAL, PA","CHICAGO 47TH ST TV, IL",2023-07-07,8,10,2
3630155807,"CHICAGO, IL","CHICAGO MIX CTR, IL",2023-07-07,2,2,0
3630052570,"BLUFFTON, IN","SELMA, NC",2023-07-07,10,10,0
3630184539,"SEATTLE, WA","NORFOLK INTERNATION, VA",2023-07-07,6,4,-2
3630079108,"WINSTON-SALEM, NC","RABER, IN",2023-07-07,11,8,-3
1087643863,"SHARONVILLE, OH","NORFOLK INTERNATION, VA",2023-07-07,10,10,0
3630183965,"NORFOLK INTERNATION, VA","LANDERS, IL",2023-07-07,6,3,-3
3630181808,"SELKIRK, NY","LAFAYETTE, IN",2023-07-07,8,7,-1
1087646439,"ICTF, CA","GEORGETOWN, KY",2023-07-07,6,7,1
3630205301,"SCHENECTADY, NY","TAYLOR, PA",2023-07-07,6,5,-1
3630193546,"LAMBERTS POINT, VA","WILLIAMSON YARD, WV",2023-07-07,2,2,0
3630207743,"NEW HAVEN, IN","OAKWOOD, GA",2023-07-07,2,1,-1
3630054514,"CAROL, IN","FRANCISCO, IN",2023-07-07,3,3,0
3630061147,"CHICAGO, IL","GEORGETOWN, KY",2023-07-07,6,7,1
3630075099,"KNOXVILLE, TN","CHICAGO, IL",2023-07-07,2,4,2
3630067606,"ZACHA JCT, TX","BROWNSON, AL",2023-07-07,6,3,-3
3630095968,"FOSTORIA, OH","CHICAGO, IL",2023-07-07,3,4,1
1087588746,"CANTON, OH","UNION, SC",2023-07-07,6,4,-2
1087601667,"CINCINNATI, OH","LONG BEACH E PIER, CA",2023-07-07,8,6,-2
3630120959,"TOLEDO, OH","MIDDLETOWN, OH",2023-07-07,6,6,0
3630059514,"KNOXVILLE, TN","KANKAKEE, IL",2023-07-07,7,8,1
3630127309,"BURNS HARBOR, IN","BURNS HARBOR, IN",2023-07-07,10,7,-3
3630152207,"MITSUE, AB","LORAY, NC",2023-07-07,6,5,-1
1087676379,"NORFOLK INTERNATION, VA","LANDERS, IL",2023-07-07,5,5,0
1087538733,"LOS ANGELES, CA","CROXTON, NJ",2023-07-07,6,7,1
3630170027,"LAMBERTS POINT, VA","WILLIAMSON YARD, WV",2023-07-07,0,3,3
1087523704,"BLUFFTON, IN","SELMA, NC",2023-07-07,10,8,-2
3630186769,"DALLAS, TX","HARRISBURG, PA",2023-07-07,9,8,-1
1087656735,"JACKSON, AL","CHICAGO, IL",2023-07-07,4,4,0
3630048628,"CICERO, IL","CROXTON, NJ",2023-07-07,9,6,-3
1087639539,"DETROIT, MI","ELIZABETH MARINE TE, NJ",2023-07-07,9,10,1
1087629487,"ATLANTA, GA","WYLIE, TX",2023-07-07,0,2,2
3630054637,"CAROL, IN","FRANCISCO, IN",2023-07-07,0,1,1
3630199314,"WAUSAU, WI","FRANKLIN, OH",2023-07-02,7,9,2
3628723034,"LAMBERTS POINT, VA","TOMS CREEK, VA",2023-07-07,8,8,0
1087692781,"JACKSONVILLE, FL","PRINCETON, IN",2023-07-07,0,2,2
3630169987,"LOGISTICS PARK KANS, KS","JACKSONVILLE, FL",2023-07-07,10,10,0
3630057156,"LONG BEACH E PIER, CA","CINCINNATI, OH",2023-07-07,9,6,-3
3630075934,"MERIDIAN, MS","CHARLOTTE, NC",2023-07-07,1,1,0
3630077693,"STOCKTON IMF, CA","KANSAS CITY, MO",2023-07-07,6,4,-2
3630109806,"LOUISVILLE, KY","LOUISVILLE, KY",2023-07-07,2,1,-1
3630156277,"FT SMITH, AR","CANAL POINT, FL",2023-07-07,2,2,0
3630114665,"ORANGE, TX","SANDY SPRINGS, SC",2023-07-07,4,7,3
3630056095,"MERIDIAN, MS","CHARLOTTE, NC",2023-07-07,11,10,-1
1087598385,"ORANGE, TX","DAYTON, TN",2023-07-07,0,2,2
1087602558,"LEWISTOWN, PA","FREEPORT, TX",2023-07-07,7,9,2
3630130530,"READING, PA","ROUSES POINT, NY",2023-07-07,9,9,0
3630063165,"PANZACOLA, TL","CALVERT, AL",2023-07-04,7,7,0
3629131777,"SANDUSKY DOCK, OH","CROOKED CREEK MINE, PA",2023-07-07,11,8,-3
3630108274,"VALDOSTA, GA","BURNSVILLE, MS",2023-07-07,1,3,2
3630064404,"RICHMOND, VA","TROUTVILLE, VA",2023-07-07,6,8,2
1087548924,"CANTON, OH","DYER, PA",2023-07-07,7,8,1
3630067818,"LOS ANGELES, CA","RUTHERFORD, PA",2023-07-07,3,4,1
3630118732,"TUNKHANNOCK, PA","CLAYTON, IA",2023-07-07,1,3,2
3630177516,"MEMPHIS, TN","BROWNSTOWN, MI",2023-07-07,8,10,2
3630082486,"SALINAS VICTORIA, NL","AUSTELL, GA",2023-07-07,9,6,-3
3630199877,"PEDRICKTOWN, NJ","HOUSTON, TX",2023-07-07,10,8,-2
3630138287,"WYLIE, TX","ATLANTA, GA",2023-07-07,7,8,1
1087601154,"CROYDON, PA","MORRISVILLE, PA",2023-07-07,-2,1,3
3630132948,"SELKIRK, NY","BUFFALO, NY",2023-07-07,0,3,3
1087608334,"STONY CREEK, PA",", ",2023-07-07,5,2,-3
3630090023,"MERIDIAN, MS","JACKSONVILLE, FL",2023-07-07,9,7,-2
1087605093,"TAYLOR, PA","TACSIM, WA",2023-07-07,3,3,0
3630114437,"KNOXVILLE, TN","NEWBERRY, PA",2023-07-07,6,3,-3
3630126214,"MIDDLETOWN, OH","CINCINNATI, OH",2023-07-07,4,3,-1
3630105014,"BAYTOWN, TX","EUCLID, OH",2023-07-07,11,8,-3
3630061723,"SAN BERNARDINO, CA","CHARLOTTE, NC",2023-07-07,2,1,-1
3630104408,"BERKELEY, MO","GREEN BAY, WI",2023-07-07,5,8,3
3630072295,"LAGRANGE, NL","MAUMEE, OH",2023-07-07,4,5,1
3630107375,"SANDUSKY DOCK, OH","CROOKED CREEK MINE, PA",2023-07-07,1,3,2
1087535921,"LAMBERTS POINT, VA","WILLIAMSON YARD, WV",2023-07-07,-1,2,3
3630080191,"HYCO, NC","BAILEY MINE, PA",2023-07-07,5,7,2
3630192231,"FAIR OAKS, VA","AVONDALE, LA",2023-07-07,10,7,-3
3630059637,"BEAVER DAM, KY","WESTVACO, WY",2023-07-07,1,1,0
3630127448,"TOLEDO, OH","INDIANA HARBOR, IN",2023-07-07,7,8,1
1087574771,"LAFAYETTE, IN","LAFAYETTE, IN",2023-07-07,-2,1,3
1087634246,"SHARONVILLE, OH","SHARONVILLE, OH",2023-07-07,5,8,3
3630156049,"ELDON, TX","LAKE CITY, FL",2023-07-07,4,1,-3
3630217900,"HOUSTON, TX","CROXTON, NJ",2023-07-07,-1,2,3
1087648384,"DETROIT DEARBORN, MI","BIRMINGHAM, MO",2023-07-07,4,7,3
1087543932,"COLUMBUS, GA","STE GENEVIEVE, MO",2023-07-07,3,5,2
1087634123,"SHARONVILLE, OH","SHARONVILLE, OH",2023-07-07,0,1,1
3630073411,"CHICAGO 47TH ST TV, IL","CHICAGO 47TH ST TV, IL",2023-07-07,-2,1,3
3630060913,"CHICAGO, IL","TOLEDO, OH",2023-07-07,-1,1,2
3630159380,"LOS ANGELES, CA","AUSTELL, GA",2023-07-02,3,3,0
3628755780,"CAROL, IN","FRANCISCO, IN",2023-07-07,2,2,0
3630142367,"THOMASTON, IN","MONROE, MI",2023-07-07,5,5,0
3630107105,"SANDUSKY DOCK, OH","CROOKED CREEK MINE, PA",2023-07-07,9,10,1
3630197087,"SANDERSVILLE, GA","BATTLE CREEK, MI",2023-07-07,6,8,2
3630080620,"HYCO, NC","BAILEY MINE, PA",2023-07-07,-2,1,3
3630073152,"BALT SPARROWS POINT, MD","ROANOKE, VA",2023-07-07,3,3,0
3630209892,"DECATUR, AL","DECATUR, AL",2023-07-07,8,5,-3
3630151471,"HAVERHILL, OH","EDMONTON, AB",2023-07-07,4,7,3
1087664699,"MARCUS, IA","ATLANTA, GA",2023-07-07,10,9,-1
3630200199,"WEST HAZLETON, PA","MARYLAND, LA",2023-07-07,7,4,-3
3630077716,"STOCKTON IMF, CA","JACKSONVILLE, FL",2023-07-07,5,7,2
3630193300,"SARNIA, ON","SANDY SPRINGS, SC",2023-07-07,12,9,-3
1087704504,"VOLGA, SD","SADDLE BROOK, NJ",2023-07-07,2,3,1
1087595777,"READING, PA","KRANNERT, GA",2023-07-07,3,5,2
1087594373,"AUSTELL, GA","GARDEN CITY, GA",2023-07-07,7,8,1
3630093186,"LOS ANGELES, CA","JACKSONVILLE, FL",2023-07-07,9,6,-3
3630190776,"MELVINDALE, MI","KANSAS CITY, MO",2023-07-07,7,9,2
3630175263,"SIMCO, ID","BERKELEY, MO",2023-07-07,7,9,2
3630155823,"ICTF, CA","GEORGETOWN, KY",2023-07-07,2,3,1
1087692993,"JACKSONVILLE, FL","PRINCETON, IN",2023-07-07,9,6,-3
1087559909,"STUARTS DRAFT, VA","DOUGLAS, GA",2023-07-07,6,5,-1
3630189026,"LITTLETON, MA","DECATUR, AL",2023-07-06,1,4,3
1087304786,"LAMBERTS POINT, VA","TOMS CREEK, VA",2023-07-07,-1,2,3
3630093479,"WADSWORTH, TX","LENOIR, NC",2023-07-07,4,4,0
3630190336,"LEMOYNE, AL","MOBILE, AL",2023-07-07,1,2,1
3630122561,"HOUSTON, TX","PEDRICKTOWN, NJ",2023-07-07,7,10,3
1087538806,"MIDDLETOWN, OH","CALVERT, AL",2023-07-07,9,10,1
1087542897,"ATLANTA, GA","WYLIE, TX",2023-07-07,0,3,3
1087657969,"LOUDON, TN","LOUDON, TN",2023-07-07,5,2,-3
3630062402,"LOS ANGELES, CA","RUTHERFORD, PA",2023-07-07,6,9,3
3630109466,"LEMOYNE, AL","MOBILE, AL",2023-07-07,4,1,-3
1087684843,"MORRISVILLE, PA","CHICAGO, IL",2023-07-07,9,7,-2
3630059726,"MODESTO, CA","SCRANTON, PA",2023-07-07,9,6,-3
3630189589,"COLUMBIA CITY, IN","ST LOUIS, MO",2023-07-07,1,4,3
3630062850,"SAN BERNARDINO, CA","JACKSONVILLE, FL",2023-07-07,4,5,1
3630208008,"MOGADORE, OH","HICKORY, NC",2023-07-07,5,6,1
1087655438,"LOS ANGELES, CA","HARRISBURG, PA",2023-07-07,11,9,-2
3630127707,"TOLEDO, OH","INDIANA HARBOR, IN",2023-07-07,5,4,-1
3630178538,"FOSTORIA, OH","DOWNS, KS",2023-07-02,2,5,3
3628671677,"CHARLOTTE, NC","WHITE PIGEON, MI",2023-07-03,8,10,2
3628906577,"SANDUSKY DOCK, OH","CROOKED CREEK MINE, PA",2023-07-07,11,10,-1
3630211328,"LAKE CHARLES, LA","ASHEBORO, NC",2023-07-07,10,10,0
3630148672,"EAST MODESTO, CA","ALTOONA, PA",2023-07-07,7,10,3
3630070340,"MODESTO, CA","JACKSONVILLE, FL",2023-07-07,6,9,3
1087618834,"BELLEFONTE, PA","BESSEMER, PA",2023-07-07,-1,2,3
3630194518,"SAN BERNARDINO, CA","JACKSONVILLE, FL",2023-07-07,10,8,-2
3630068408,"CHICAGO, IL","CROXTON, NJ",2023-07-07,2,4,2
3630152980,"HILL, AL","DAWSON, GA",2023-07-07,0,3,3
1087518733,"TROUTVILLE, VA","CEDARVILLE, VA",2023-07-07,9,6,-3
3630102278,"ARBELA, MS","COLUMBUS, OH",2023-07-07,6,4,-2
1087552143,"AUSTELL INTERMODAL, GA","ICTF, CA",2023-07-07,6,7,1
3630092350,"WAYNESBURG, PA","BETHLEHEM, PA",2023-07-07,6,6,0
1087707798,"AUSTELL, GA","SAN BERNARDINO, CA",2023-07-07,-1,2,3
3630066634,"SAN BERNARDINO, CA","JACKSONVILLE, FL",2023-07-07,1,2,1
3630048652,"CICERO, IL","HARRISBURG, PA",2023-07-07,7,7,0
3630158457,"BURNS HARBOR, IN","BURNS HARBOR, IN",2023-07-07,12,9,-3
1087691052,"RUTHERFORD, PA","TITUSVILLE, FL",2023-07-07,11,9,-2
3630191269,"BAYONNE, NJ","BELLE CHASSE, LA",2023-07-07,7,6,-1
3630129678,"ASHEBORO, NC","ELDON JCT, TX",2023-07-07,7,9,2
1087574412,"WAYNESBURG, PA","BETHLEHEM, PA",2023-07-07,9,7,-2
3630186468,"WYLIE, TX","TITUSVILLE, FL",2023-07-07,11,10,-1
3630103787,"SHELBYVILLE, KY","HOUSTON, TX",2023-07-04,10,9,-1
3629142435,"SANDUSKY DOCK, OH","CROOKED CREEK MINE, PA",2023-07-07,6,9,3
3630076825,"LOS ANGELES, CA","JACKSONVILLE, FL",2023-07-07,6,8,2
1087652325,"WAYNE, MI","GARY, IN",2023-07-07,6,7,1
3630173114,"MELVINDALE, MI","KANSAS CITY, MO",2023-07-07,2,5,3
3630074784,"AMELIA, TX","SYLACAUGA, AL",2023-07-07,0,3,3
1087664194,"CHICAGO, IL","COLUMBUS, OH",2023-07-07,5,5,0
3630199738,"CEDAR RAPIDS, IA","CITY POINT, FL",2023-07-07,3,4,1
3630109775,"LOUISVILLE, KY","LOUISVILLE, KY",2023-07-07,1,4,3
3630098932,"ASHEVILLE, NC","SCIO, OH",2023-07-07,3,5,2
3630134047,"FLORENCE, SC","COLUMBIA, SC",2023-07-07,10,9,-1
1087653216,"LACYMARK, FL","JUNCTION CITY, GA",2023-07-07,8,10,2
3630109660,"LOUISVILLE, KY","LOUISVILLE, KY",2023-07-07,6,3,-3
3630204800,"POSTELL, GA","ODUM, GA",2023-07-07,10,9,-1
3630155946,"ARKANSAS CITY, KS","CAMP HILL, PA",2023-07-07,2,4,2
3630057774,"NEAL, WV","KENOVA, WV",2023-07-07,3,6,3
1087553092,"ASHEBORO, NC","LAKE CHARLES, LA",2023-07-07,4,4,0
3630130483,"UNION BRIDGE, MD","DURHAM, NC",2023-07-07,11,10,-1
1087693436,"TOLEDO, OH","CHICAGO, IL",2023-07-07,9,10,1
1087669908,"LATHROP, CA","FREMONT, OH",2023-07-07,12,9,-3
3630075722,"MELVINDALE, MI","KANSAS CITY, MO",2023-07-07,3,6,3
3630110792,"CHICAGO ENGLEW TV, IL","CICERO, IL",2023-07-02,0,3,3
3628756508,"CAROL, IN","FRANCISCO, IN",2023-07-07,6,7,1
3630172702,"LAFAYETTE, IN","LAFAYETTE, IN",2023-07-07,4,4,0
3630207133,"WHITE RIVER JCT, VT","LUDLOWVILLE (ITHR), NY",2023-07-07,4,4,0
3630144733,"SIDNEY, IL","GUELPH, ON",2023-07-07,2,3,1
1087558513,"TOLEDO, OH","TOLEDO, OH",2023-07-07,6,5,-1
3630208618,"WESTLAKE, FL","GEORGETOWN, KY",2023-07-02,10,9,-1
3628723327,"LAMBERTS POINT, VA","TOMS CREEK, VA",2023-07-07,13,10,-3
3630202947,"LAMBERTS POINT, VA","TOMS CREEK, VA",2023-07-07,8,5,-3
3630107626,"SANDUSKY DOCK, OH","CROOKED CREEK MINE, PA",2023-07-07,6,9,3
1087560829,"HYCO, NC","BAILEY MINE, PA",2023-07-07,7,10,3
3630059190,"LONG BEACH E PIER, CA","CINCINNATI, OH",2023-07-07,7,4,-3
3630186824,"TACOMA EXPORT, WA","COLUMBUS, OH",2023-07-07,6,4,-2
1087541605,"CINCINNATI, OH","CALUMET, IL",2023-07-07,8,8,0
1087599420,"NAHEOLA, AL","ALLEMANIA, LA",2023-07-07,8,8,0
3630087088,"KANSAS CITY, MO","MELVINDALE, MI",2023-07-07,5,5,0
3630068458,"CHICAGO, IL","COLUMBUS, OH",2023-07-07,9,9,0
3630098136,"CONALCO, TN","MOUNT CARMEL JCT, PA",2023-07-07,10,8,-2
1087612993,"AUSTELL, GA","PORTLAND, OR",2023-07-07,3,1,-2
1087669592,"CHICAGO ENGLEW TV, IL","MECHANICVILLE, NY",2023-07-07,1,3,2
3630078217,"PORT OF CLEVELAND, OH","LONGVIEW, TX",2023-07-07,2,1,-1
1087537321,"ROSSVILLE, TN","CROXTON, NJ",2023-07-07,0,3,3
3630207565,"CLINTON, IA","BALTIMORE, MD",2023-07-07,7,4,-3
3630093013,"WAYNESBURG, PA","BETHLEHEM, PA",2023-07-07,4,2,-2
3630049527,"PORT WENTWORTH, GA","LUDLOW, KY",2023-07-07,10,9,-1
3630199916,"ROBERTS BANK, BC","CLEVELAND, OH",2023-07-07,4,1,-3
1087639034,"HAMPTON, GA","ANDERSON, TN",2023-07-07,2,1,-1
3630116227,"PORTLAND, OR","AUSTELL, GA",2023-07-07,2,1,-1
1087566451,"SAVANNAH, GA","CLYATTVILLE, GA",2023-07-07,4,7,3
1087636727,"CHOCOWINITY, NC","HODGES, TN",2023-07-07,4,3,-1
3630092156,"WELLSBORO, PA","WYEVILLE, WI",2023-07-07,3,6,3
1087682867,"NATKA (AIKR), SC","LAKE CHARLES, LA",2023-07-02,3,3,0
3628751647,"LAMBERTS POINT, VA","TOMS CREEK, VA",2023-07-07,4,1,-3
1087651866,"DETROIT, MI","PORTSMOUTH APMT, VA",2023-07-07,-1,2,3
1087603279,"CRESSON, PA","CRAB ORCHARD, TN",2023-07-07,9,6,-3
1087658787,"RADFORD, NC","ROCK ISLAND JCT, IL",2023-07-07,0,1,1
1087560722,"HYCO, NC","BAILEY MINE, PA",2023-07-07,2,1,-1
3630187684,"ANDERSONVILLE, GA","VANDALIA, MO",2023-07-07,1,4,3
3630153237,"HUNTSVILLE, AL","ATHENS, AL",2023-07-07,10,10,0
3630186955,"LOS ANGELES, CA","AUSTELL, GA",2023-07-07,6,9,3
3630122799,"MERIDIAN, MS","MIAMI, FL",2023-07-07,13,10,-3
3630192192,"EAST ST LOUIS, IL","LOUISVILLE, KY",2023-07-07,11,8,-3
3630093649,"FERGUSON, MS","ALBION, MI",2023-07-07,6,5,-1
3630152956,"WORCESTER, MA","BRAITHWAITE, LA",2023-07-07,5,5,0
1087636248,"WEST POINT, VA","STATESVILLE (ARC), NC",2023-07-07,5,8,3
3630119348,"NEW ORLEANS, LA","TYNER, TN",2023-07-07,2,4,2
3630100381,"LEESBURG, OH","CHICAGO ASHLAND AVE, IL",2023-07-07,5,8,3
1087672757,"RUTHERFORD, PA","JACKSONVILLE, FL",2023-07-07,4,6,2
1087705835,"MASON CITY, IA","CORDELE (HOG), GA",2023-07-07,1,4,3
3630198300,"BROWNSON, AL","PICAYUNE, MS",2023-07-07,13,10,-3
3630215712,"BALTIMORE, MD","PORT ARTHUR, TX",2023-07-07,8,9,1
1087554909,"MORRISVILLE TV, PA","CHICAGO ENGLEW TV, IL",2023-07-07,2,3,1
3630074441,"LOS ANGELES, CA","CROXTON, NJ",2023-07-07,10,10,0
1087532355,"LONG BEACH E PIER, CA","CLEVELAND, OH",2023-07-07,9,6,-3
3630154607,"LUDLOWVILLE (ITHR), NY","SHELBURNE, VT",2023-07-07,11,8,-3
3630208529,"WESTLAKE, FL","GEORGETOWN, KY",2023-07-07,3,2,-1
3630180917,"CHICAGO, IL","LEXINGTON, KY",2023-07-07,7,8,1
3630198106,"AYER, MA","GEORGETOWN, KY",2023-07-07,5,7,2
3630158172,"BURNS HARBOR, IN","BURNS HARBOR, IN",2023-07-07,8,7,-1
1087693583,"WESTVACO, WY","YORK, PA",2023-07-07,12,9,-3
3630150996,"DECATUR, IL","HOMER, IL",2023-07-07,11,9,-2
3630212798,"WINSTON-SALEM, NC","HOBBS, IN",2023-07-02,8,8,0
3628723597,"LAMBERTS POINT, VA","TOMS CREEK, VA",2023-07-07,7,9,2
3630054564,"CAROL, IN","FRANCISCO, IN",2023-07-07,2,5,3
1087664217,"BELLEVUE, OH","BROADWAY, VA",2023-07-07,9,8,-1
1087609356,"TAYLOR, PA","CHICAGO, IL",2023-07-07,3,4,1
1087561118,"HYCO, NC","BAILEY MINE, PA",2023-07-07,3,2,-1
3630118295,"COURTRIGHT, ON","BELEWS CREEK, NC",2023-07-07,12,9,-3
3630173944,"FAIRFIELD, AL","MILLPORT, AL",2023-07-07,1,3,2
3630123818,"OLD FORT, OH","BENTONITE, WY",2023-07-07,4,7,3
3630172265,"AURORA, MO","LAFAYETTE, IN",2023-07-07,1,3,2
3630175904,"REIDSVILLE, NC","LEMOYNE, AL",2023-07-02,4,7,3
3628756998,"CAROL, IN","FRANCISCO, IN",2023-07-07,4,7,3
3630122692,"LOGISTICS PARK KANS, KS","JACKSONVILLE, FL",2023-07-07,13,10,-3
1087596260,"COLUMBUS, OH","TACOMA, WA",2023-07-07,11,10,-1
1087529506,"LAMBERTS POINT, VA","WILLIAMSON YARD, WV",2023-07-07,13,10,-3
3630166353,"DES MOINES, IA","DES MOINES, IA",2023-07-07,7,8,1
3630189458,"CORCORAN, CA","CELINA, OH",2023-07-07,5,6,1
3630058194,"MACON, GA","MACON, GA",2023-07-07,6,4,-2
3630196170,"DECATUR, AL","WYTHEVILLE, VA",2023-07-07,8,9,1
3630215403,"MARCUS HOOK, PA","SPARTANBURG, SC",2023-07-07,11,9,-2
3630093615,"GARY, IN","MIDWEST PORTAGE, IN",2023-07-07,4,3,-1
1087591189,"VALDOSTA, GA","BURNSVILLE, MS",2023-07-07,4,4,0
1087571650,"MERIDIAN, MS","MIAMI, FL",2023-07-07,2,5,3
1087544182,"ROSSER, GA","BARNESVILLE, GA",2023-07-07,7,4,-3
1087573686,"WYLIE, TX","CHARLOTTE, NC",2023-07-07,-1,2,3
1087673494,"DEMOPOLIS, AL","HILL, AL",2023-07-07,-2,1,3
3630138122,"GRAINGERS, NC","LOUDON, TN",2023-07-07,10,10,0
1087546370,"MORRISVILLE, PA","CHICAGO, IL",2023-07-07,8,6,-2
3630065078,"SIDNEY, OH","HALIFAX, VA",2023-07-07,7,5,-2
1087636141,"DECATUR, AL","HARRISONVILLE, MO",2023-07-06,9,10,1
1087328269,"NORFOLK, VA","LIVERNOIS, MI",2023-07-07,10,10,0
1087670381,"DISCOVERY PARK, OH","NORFOLK INTERNATION, VA",2023-07-07,7,7,0
3630175815,"LOUISVILLE, KY","LOUISVILLE, KY",2023-07-07,9,8,-1
3630190310,"LAMBERTS POINT, VA","WILLIAMSON YARD, WV",2023-07-07,7,4,-3
3630135603,"MANSFIELD, OH","FRANKFORD (DCR), DE",2023-07-07,4,5,1
3630099271,"LOS ANGELES, CA","AUSTELL, GA",2023-07-07,4,6,2
1087529580,"LAMBERTS POINT, VA","WILLIAMSON YARD, WV",2023-07-07,10,7,-3
3630187595,"SALISBURY (DCR), MD","SADDLE BROOK, NJ",2023-07-07,10,10,0
3630077863,"JACKSON, MS","FT PAYNE, AL",2023-07-07,4,3,-1
3630205767,"WARRENTON, OH","SPARTA, WI",2023-07-07,2,4,2
3630112540,"GAINESVILLE, GA","CLAVET, SK",2023-07-07,9,10,1
1087640742,"AUSTELL, GA","CHICAGO, IL",2023-07-07,4,5,1
3630205628,"ROCKPORT, IN","MANSFIELD, OH",2023-07-07,4,6,2
1087696832,"WEST HAZLETON, PA","MARYLAND, LA",2023-07-07,-1,1,2
1087610828,"LEMOYNE, AL","OSHKOSH, WI",2023-07-07,9,10,1
3630080434,"HYCO, NC","BAILEY MINE, PA",2023-07-07,4,6,2
3630144660,"OPTIMA, OK","DECATUR, IL",2023-07-07,5,5,0
3630121858,"NEW ORLEANS, LA","NEW ORLEANS, LA",2023-07-07,1,4,3
3630059807,"LOS ANGELES, CA","HARRISBURG, PA",2023-07-07,4,2,-2
3630074213,"BAYPORT, TX","DECATUR, AL",2023-07-07,9,6,-3
3630111099,"SARNIA, ON","SANDERSVILLE, GA",2023-07-07,7,10,3
1087591595,"VALDOSTA, GA","MACON, GA",2023-07-07,1,2,1
3630056312,"MERIDIAN, MS","AUSTELL, GA",2023-07-07,3,1,-2
3630198546,"MELVINDALE, MI","KANSAS CITY, MO",2023-07-07,6,5,-1
3630181052,"NEW ORLEANS, LA","LEOLA, PA",2023-07-07,11,9,-2
3630130881,"REYBOLD, DE","LYONS, PA",2023-07-07,1,4,3
3630113473,"HOLLIDAYSBURG, PA","CLINTON, IA",2023-07-07,10,9,-1
3630109678,"LOUISVILLE, KY","LOUISVILLE, KY",2023-07-07,9,6,-3
3630149408,"CITY OF INDUSTRY, CA","PITTSBURGH, PA",2023-07-07,2,4,2
1087556252,"RUTHERFORD, PA","ATLANTA, GA",2023-07-07,0,3,3
3630058097,"LONG BEACH E PIER, CA","CLEVELAND, OH",2023-07-07,0,1,1
1087616727,"BURNS HARBOR, IN","BURNS HARBOR, IN",2023-07-07,7,8,1
3630175132,"LOS ANGELES, CA","JACKSONVILLE, FL",2023-07-07,4,5,1
1087517842,"AUSTELL INTERMODAL, GA","LATHROP, CA",2023-07-07,11,9,-2
3630127723,"TOLEDO, OH","INDIANA HARBOR, IN",2023-07-07,7,8,1
3630169440,"APPLE GROVE, WV","HARMAN, MD",2023-07-07,7,5,-2
1087563152,"GLIDDEN, GA","FAIRBANK, IA",2023-07-07,10,7,-3
1087706687,"NEW ORLEANS, LA","NEW ORLEANS, LA",2023-07-07,10,7,-3
1087636400,"ARMOREL, AR","SAVANNAH, GA",2023-07-07,10,10,0
3630085646,"HERSHEY, PA","WAHPETON, ND",2023-07-07,5,4,-1
3630178627,"PALMERTON, PA","COLUMBIA CITY, IN",2023-07-07,0,1,1
3630139877,"DECATUR, IL","HAPEVILLE, GA",2023-07-07,8,7,-1
3630070675,"SAN BERNARDINO, CA","JACKSONVILLE, FL",2023-07-07,8,9,1
1087557795,"LOS ANGELES, CA","AUSTELL, GA",2023-07-07,13,10,-3
1087551650,"KANSAS CITY, MO","ELIZABETH MARINE TE, NJ",2023-07-07,6,6,0
3630098380,"NEW BERN, NC","BURNSVILLE, MS",2023-07-07,9,9,0
3630207620,"ROBERTS BANK, BC","COLUMBUS, OH",2023-07-07,4,6,2
1087575133,"WAYNESBURG, PA","BETHLEHEM, PA",2023-07-07,2,3,1
3630054734,"CAROL, IN","FRANCISCO, IN",2023-07-07,11,10,-1
1087526150,"MIDDLETOWN, OH","ROCKPORT, IN",2023-07-07,2,2,0
3630134039,"FLORENCE, SC","COLUMBIA, SC",2023-07-07,5,2,-3
3630185925,"GEORGETOWN, KY","WESTLAKE, FL",2023-07-07,8,5,-3
1087634602,"SHARONVILLE, OH","SHARONVILLE, OH",2023-07-07,0,3,3
3630078592,"LOS ANGELES, CA","JACKSONVILLE, FL",2023-07-07,1,3,2
3630148494,"ST PAUL, MN","JACKSONVILLE, FL",2023-07-07,2,4,2
1087599585,"PAINTED POST, NY","LEXINGTON, NE",2023-07-07,13,10,-3
3630126400,"MALLARD, AL","DECATUR, AL",2023-07-07,5,3,-2
3630170271,"TIPTON, IN","MAHRT (CCH), AL",2023-07-07,4,7,3
1087518050,"PITCAIRN, PA","ELIZABETH MARINE TE, NJ",2023-07-07,10,10,0
3630208935,"MAHANOY CITY, PA","MYERS, ID",2023-07-07,5,7,2
3630132964,"SELKIRK, NY","BUFFALO, NY",2023-07-07,9,10,1
1087564687,"BUFFALO BISON, NY","VOLTZ MIX CTR, MO",2023-07-07,12,10,-2
3630078411,"LOS ANGELES, CA","COLUMBUS, OH",2023-07-03,5,5,0
3628888680,"WINSTON-SALEM, NC","WHITE PIGEON, MI",2023-07-07,4,3,-1
3630199089,"WAUSAU, WI","AVERY, OH",2023-07-07,7,8,1
3630111031,"EAST CHICAGO, IN","GRANITE CITY, IL",2023-07-07,6,6,0
3630182294,"MELVINDALE, MI","KANSAS CITY, MO",2023-07-07,10,9,-1
3630187066,"PELHAM, GA","NORTH MANCHESTER, IN",2023-07-07,4,2,-2
3630125797,"BURNS HARBOR, IN","CLEVELAND, OH",2023-07-07,8,8,0
3630062054,"LAMBERTS POINT, VA","WILLIAMSON YARD, WV",2023-07-07,2,5,3
3630168892,"PORT OF PALM BEACH, FL","CINCINNATI, OH",2023-07-04,9,10,1
3629137650,"SANDUSKY DOCK, OH","CROOKED CREEK MINE, PA",2023-07-07,9,10,1
3630189602,"COLUMBIA CITY, IN","ST LOUIS, MO",2023-07-07,11,8,-3
3630065418,"BIRMINGHAM, MO","DETROIT DEARBORN, MI",2023-07-07,7,8,1
3630195776,"BOYKINS, VA","HUBBARD, OH",2023-07-07,-2,1,3
3630146337,"SUTTON, FL","CHARLESTON, TN",2023-07-07,10,10,0
1087518589,"TROUTVILLE, VA","BRISTOL, VA",2023-07-07,7,8,1
3630072570,"LAGRANGE, NL","STERLING HEIGHTS, MI",2023-07-07,11,9,-2
1087599941,"CHAPMAN, PA","SHAWMUT, ME",2023-07-07,3,3,0
1087590808,"SANDUSKY DOCK, OH","CROOKED CREEK MINE, PA",2023-07-07,5,8,3
3630109644,"LOUISVILLE, KY","LOUISVILLE, KY",2023-07-07,-1,1,2
3630109123,"NORFOLK NPBL, VA","ARVIDA, PQ",2023-07-07,11,8,-3
1087541346,"WENTZVILLE, MO","WENTZVILLE, MO",2023-07-07,4,3,-1
1087599577,"CROXTON, NJ","LOS ANGELES, CA",2023-07-04,8,7,-1
3629171620,"SANDUSKY DOCK, OH","CROOKED CREEK MINE, PA",2023-07-07,9,6,-3
1087522334,"AUSTELL INTERMODAL, GA","PORTLAND, OR",2023-07-07,2,5,3
1087526833,"BUTLER, IN","BURNS HARBOR, IN",2023-07-07,7,7,0
3630112443,"GAINESVILLE, GA","GAINESVILLE, GA",2023-07-07,2,1,-1
3630125399,"BURNS HARBOR, IN","BURNS HARBOR, IN",2023-07-07,11,10,-1
1087547512,"ELKHART, IN","DELTA, OH",2023-07-07,4,1,-3
3630133198,"SELKIRK, NY","BUFFALO, NY",2023-07-07,4,2,-2
3630191675,"GHENT, KY","BRACKENRIDGE, PA",2023-07-07,6,3,-3
3630125381,"LEMOYNE, AL","OSHKOSH, WI",2023-07-07,10,7,-3
3630066595,"LOS ANGELES, CA","BALTIMORE, MD",2023-07-07,0,2,2
3630104385,"MAGNOLIA, GA","ROBERTA, AL",2023-07-07,4,5,1
1087617537,"NEW ORLEANS, LA","QUINCY, IL",2023-07-07,6,6,0
3630204355,"POSTELL, GA","PANAMA CITY, FL",2023-07-07,11,8,-3
1087581998,"LULING, LA","AUGUSTA, GA",2023-07-07,8,6,-2
3630093487,"WADSWORTH, TX","BRIDGEPORT (SLRS), NJ",2023-07-07,5,6,1
3630218621,"KENOVA, WV","MOCKSVILLE, NC",2023-07-07,3,2,-1
3630070633,"LAMBERTS POINT, VA","WILLIAMSON YARD, WV",2023-07-07,2,3,1
3630109589,"LOUISVILLE, KY","LOUISVILLE, KY",2023-07-07,-1,2,3
3630127749,"TOLEDO, OH","INDIANA HARBOR, IN",2023-07-07,6,4,-2
3630199631,"CEDAR RAPIDS, IA","SPARTANBURG, SC",2023-07-07,9,10,1
3630126939,"DOVER, OH","HAVERHILL, OH",2023-07-07,5,8,3
3630152029,"EAST ST LOUIS, IL","BLUFFTON, IN",2023-07-07,6,9,3
3630189725,"COLUMBIA CITY, IN","ST LOUIS, MO",2023-07-07,3,3,0
1087616214,"BURNS HARBOR, IN","BURNS HARBOR, IN",2023-07-07,9,9,0
1087657862,"ZORRA, ON","SIEGFRIED, PA",2023-07-07,2,4,2
3630195881,"LOUISVILLE, KY","CALVERT CITY, KY",2023-07-07,0,3,3
3630145632,"BIRMINGHAM, MO","DETROIT DEARBORN, MI",2023-07-07,1,2,1
1087693533,"WESTVACO, WY","AUBURN, NY",2023-07-07,5,6,1
3630069030,"PHOENIX, AZ","HARRISBURG, PA",2023-07-07,9,9,0
3630089909,"FREMONT, OH","YORK, PA",2023-07-07,1,4,3
3630212722,"WINSTON-SALEM, NC","HOBBS, IN",2023-07-07,5,2,-3
3630099530,"BATAVIA (CCET), OH","HODGKINS, IL",2023-07-07,4,7,3
3630187707,"ANDERSONVILLE, GA","VANDALIA, MO",2023-07-07,5,8,3
3630157477,"SAVANNAH, GA","DORAVILLE, GA",2023-07-07,10,9,-1
3630070413,"ROSSVILLE, TN","ROSSVILLE, TN",2023-07-07,1,1,0
1087583063,"CLAY, DE","THOMASTON, IN",2023-07-07,9,9,0
1087540609,"NORTH BIRMINGHAM, AL","MOBILE, AL",2023-07-07,10,8,-2
1087614424,"MALLARD, AL","DECATUR, AL",2023-07-07,5,3,-2
3630184424,"NORTH CHARLESTON, SC","FOREST PARK, GA",2023-07-07,5,3,-2
3630061090,"CHICAGO, IL","GEORGETOWN, KY",2023-07-05,9,8,-1
1087003330,"SURRENCY, GA","ANDERSON (ICRK), IN",2023-07-07,5,2,-3
1087665386,"JACKSONVILLE, FL","ST LOUIS, MO",2023-07-07,9,10,1
3630062096,"BELLEVUE, OH","BELLEVUE, OH",2023-07-07,9,9,0
3630155865,"ICTF, CA","GEORGETOWN, KY",2023-07-07,4,4,0
1087643619,"COLUMBUS, OH","BUTLER, IN",2023-07-07,3,3,0
3630081919,"BUTLER, IN","EAST CHICAGO, IN",2023-07-07,7,7,0
1087564077,"CALVERT CITY, KY","EMORY GAP, TN",2023-07-07,12,9,-3
3630167731,"RADFORD, NC","ROCK ISLAND JCT, IL",2023-07-07,0,1,1
1087531236,"BELLEVUE, OH","BELLEVUE, OH",2023-07-07,2,3,1
3630052122,"BLUFFTON, IN","SELMA, NC",2023-07-07,13,10,-3
3630187016,"PELHAM, GA","NORTH MANCHESTER, IN",2023-07-07,-1,1,2
1087691492,"GORDON, GA","JACKSON, TN",2023-07-07,6,3,-3
1087628944,"CHARLOTTE, NC","CHICAGO, IL",2023-07-07,4,5,1
3630171879,"PINE BLUFF, AR","WAYNESVILLE (BLU), NC",2023-07-07,6,3,-3
1087552656,"WILLOW SPRINGS, IL","WILLOW SPRINGS, IL",2023-07-07,4,1,-3
3630203561,"LAMBERTS POINT, VA","TOMS CREEK, VA",2023-07-07,1,4,3
3630153910,"HAVERHILL, OH","CHOCOLATE BAYOU, TX",2023-07-07,4,7,3
3630069200,"TACOMA BLAIR, WA","CLEVELAND, OH",2023-07-07,8,8,0
1087674610,"TOLEDO, OH","COLUMBIA CITY, IN",2023-07-07,6,6,0
3630121028,"TOLEDO, OH","MIDDLETOWN, OH",2023-07-07,1,3,2
3630163135,"VERNON, CA","CARROLL, TN",2023-07-07,5,2,-3
1087595442,"BLACKSBURG, SC","PALMERTON, PA",2023-07-07,4,6,2
3630130556,"SUFFOLK, VA","NEW ORLEANS, LA",2023-07-07,4,6,2
3630093843,"MEMPHIS, TN","CHARLOTTE, NC",2023-07-07,5,3,-2
1087529700,"NEAL, WV","KENOVA, WV",2023-07-07,10,9,-1
1087567554,"JACKSONVILLE, FL","CALUMET, IL",2023-07-07,9,8,-1
1087705974,"VOLTZ, MO","EAST ST LOUIS, IL",2023-07-07,5,8,3
3630094051,"MEMPHIS, TN","JACKSONVILLE, FL",2023-07-07,6,9,3
3630071752,"LAMBERTS POINT, VA","WILLIAMSON YARD, WV",2023-07-07,5,3,-2
3630051948,"BLUFFTON, IN","SELMA, NC",2023-07-03,9,6,-3
1086106004,"WINSTON-SALEM, NC","WHITE PIGEON, MI",2023-07-07,4,4,0
3630196269,"JACKSONVILLE, FL","PRINCETON, IN",2023-07-07,4,1,-3
1087549857,"LIVERNOIS, MI","DETROIT, MI",2023-07-07,6,5,-1
1087699482,"CORUNNA, ON","PIEDMONT, SC",2023-07-07,5,3,-2
3630096477,"BATH, PA","YOUNGSTOWN (YB), OH",2023-07-07,6,4,-2
1087701946,"MEMPHIS, TN","MEMPHIS, TN",2023-07-07,1,1,0
1087595387,"BURNS HARBOR, IN","BURNS HARBOR, IN",2023-07-07,1,3,2
3630141159,"LENOX, GA","NORTH BIRMINGHAM, AL",2023-07-07,7,10,3
3630139796,"BROWNSON, AL","GYPSUM, OH",2023-07-07,11,10,-1
3630192176,"DORAVILLE, GA","CALDWELL, ID",2023-07-07,10,9,-1
3630098330,"NEW BERN, NC","BURNSVILLE, MS",2023-07-07,6,9,3
1087715848,"DUFFS JCT (POHC), PA","NARLO, OH",2023-07-07,8,9,1
1087591244,"VALDOSTA, GA","BURNSVILLE, MS",2023-07-07,-1,2,3
3630074302,"PORTLAND, OR","BALTIMORE, MD",2023-07-07,8,9,1
3630070251,"LOS ANGELES, CA","JACKSONVILLE, FL",2023-07-07,4,3,-1
3630057588,"SHELBYVILLE, KY","CALVERT CITY, KY",2023-07-07,7,7,0
3630134657,"ELKHART, IN","PINE, IN",2023-07-07,4,5,1
3630143371,"JEFFERSONVILLE, IN","LOUISVILLE, KY",2023-07-07,3,6,3
3630158986,"NEW BRIGHTON, MN","STAPLETON, GA",2023-07-07,6,3,-3
3630141117,"GIBBSTOWN, NJ","BELLE CHASSE, LA",2023-07-07,8,6,-2
3630114657,"FREEPORT, TX","JACKSONVILLE, IL",2023-07-07,4,6,2
3630126955,"FT DODGE, IA","GYPSUM, OH",2023-07-07,4,3,-1
1087605255,"GIBBSTOWN, NJ","SCIO, OH",2023-07-07,9,8,-1
3630159584,"HURON, CA","ELWOOD, IN",2023-07-07,10,7,-3
3630197582,"NORTH BIRMINGHAM, AL","SPOCARI, AL",2023-07-07,2,2,0
3630178960,"GRAMERCY, LA","PULASKI, VA",2023-07-07,0,3,3
3630070811,"EFFINGHAM, IL","GREENVILLE, SC",2023-07-06,6,6,0
1087059412,"LAMBERTS POINT, VA","TOMS CREEK, VA",2023-07-07,12,9,-3
1087663156,"CLEVELAND, OH","NORFOLK INTERNATION, VA",2023-07-07,9,8,-1
1087528649,"LOS ANGELES, CA","RUTHERFORD, PA",2023-07-07,1,4,3
1087552410,"AUSTELL, GA","SAN BERNARDINO, CA",2023-07-07,5,8,3
1087713202,"ELKHART, IN","VOLTZ MIX CTR, MO",2023-07-07,12,10,-2
3630079302,"TWINSBURG, OH","LAFAYETTE, IN",2023-07-07,7,7,0
3630176057,"JERSEY, TN","CLYMERS, IN",2023-07-07,9,7,-2
1087636028,"BRADFORD, PA","PHOENIX, NJ",2023-07-07,5,2,-3
1087655072,"FRONT ROYAL, VA","PORTSMOUTH APMT, VA",2023-07-07,12,10,-2
3630109830,"LOUISVILLE, KY","LOUISVILLE, KY",2023-07-07,0,2,2
3630155849,"ICTF, CA","GEORGETOWN, KY",2023-07-07,8,7,-1
3630159356,"SAN BERNARDINO, CA","JACKSONVILLE, FL",2023-07-07,11,8,-3
3630068571,"CHICAGO, IL","COLUMBUS, OH",2023-07-02,11,8,-3
3628756922,"CAROL, IN","FRANCISCO, IN",2023-07-07,10,9,-1
3630076118,"MERIDIAN, MS","AUSTELL, GA",2023-07-07,0,3,3
1087528704,"DELTA, OH","SOUTH RALEIGH, NC",2023-07-07,3,2,-1
3630167799,"LANCASTER, PA","CROWLEY, LA",2023-07-07,9,8,-1
3630124856,"LOS ANGELES, CA","AUSTELL, GA",2023-07-07,12,9,-3
3630188290,"LAMBERTS POINT, VA","WILLIAMSON YARD, WV",2023-07-07,11,9,-2
3630203197,"LAMBERTS POINT, VA","TOMS CREEK, VA",2023-07-07,7,10,3
1087578898,"BATH, PA","YOUNGSTOWN (YB), OH",2023-07-06,-2,1,3
3629795830,"LAMBERTS POINT, VA","TOMS CREEK, VA",2023-07-07,5,2,-3
3630097295,"ERIE, PA","ALEXANDRIA, VA",2023-07-07,2,5,3
3630127765,"TOLEDO, OH","INDIANA HARBOR, IN",2023-07-03,6,7,1
3629125807,"SANDUSKY DOCK, OH","CROOKED CREEK MINE, PA",2023-07-07,0,3,3
3630196722,"BORON, CA","ZYLONITE, MA",2023-07-07,3,1,-2
3630189709,"COLUMBIA CITY, IN","ST LOUIS, MO",2023-07-07,10,8,-2
1087659270,"OTTAWA, IL","CLARINGTON, OH",2023-07-05,6,4,-2
1087004289,"SURRENCY, GA","ANDERSON (ICRK), IN",2023-07-07,1,3,2
1087535654,"RUTHERFORD, PA","ATLANTA, GA",2023-07-07,1,1,0
1087594577,"AUSTELL, GA","LOS ANGELES, CA",2023-07-07,2,3,1
1087530418,"NEAL, WV","SOUTH BEAMER, AB",2023-07-07,8,8,0
3630142618,"DAVISVILLE, RI","LAFAYETTE, IN",2023-07-07,6,3,-3
1087660726,"CHICAGO 47TH ST TV, IL","BETHINTERMODAL, PA",2023-07-07,4,3,-1
3630191405,"MONROE, OH","WARSAW, KY",2023-07-07,5,6,1
3630060701,"CHICAGO, IL","APPLIANCE PARK, KY",2023-07-07,6,9,3
3630114796,"CLEVELAND, OH","WAYNE, MI",2023-07-07,10,8,-2
3630088076,"BOWDEN YARD, FL","ROBERTA, AL",2023-07-07,8,8,0
3630075227,"BARSTOW, CA","NORFOLK, VA",2023-07-07,6,3,-3
1087584530,"RICKENBACKER INTER, OH","NORFOLK INTERNATION, VA",2023-07-07,11,10,-1
3630105234,"CANTON, OH","UNION, SC",2023-07-07,8,8,0
1087546346,"S JACKSONVILLE, FL","RUBY, GA",2023-07-07,1,4,3
3630207036,"MARSHALL, MN","DOUGHERTY, GA",2023-07-07,3,3,0
1087574381,"WAYNESBURG, PA","BETHLEHEM, PA",2023-07-07,3,6,3
1087523615,"BLUFFTON, IN","SELMA, NC",2023-07-07,5,2,-3
3630130653,"READING, PA","CHAPAIS, PQ",2023-07-07,2,2,0
3630058908,"LAMBERTS POINT, VA","WILLIAMSON YARD, WV",2023-07-07,2,2,0
1087633232,"AUSTELL, GA","GARDEN CITY, GA",2023-07-07,10,10,0
3630105462,"CLEVELAND, OH","BURNS HARBOR, IN",2023-07-07,5,8,3
3630173960,"KANSAS CITY, MO","PETERSBURG, VA",2023-07-07,3,2,-1
1087531684,"BELLEVUE, OH","BELLEVUE, OH",2023-07-07,5,2,-3
3630179704,"CHESAPEAKE, VA","ALBION, MI",2023-07-07,-2,1,3
3630077813,"BARSTOW, CA","CROXTON, NJ",2023-07-07,3,2,-1
3630182498,"SANDERSVILLE, GA","TAFT, LA",2023-07-07,4,7,3
3630076794,"SLCIT, UT","HARRISBURG, PA",2023-07-07,2,3,1
1087706564,"TAFT, LA","SALEM, VA",2023-07-07,2,4,2
1087668504,"JERSEY, TN","CLYMERS, IN",2023-07-07,9,6,-3
1087634709,"SHARONVILLE, OH","SHARONVILLE, OH",2023-07-07,4,2,-2
3630074807,"SCHENECTADY, NY","TAYLOR, PA",2023-07-07,8,7,-1
1087533709,"MORRISTOWN, TN","EAST GRAND FORKS, MN",2023-07-07,4,3,-1
3630056257,"MERIDIAN, MS","AUSTELL, GA",2023-07-07,4,6,2
3630219148,"DUFFS JCT (POHC), PA","NARLO, OH",2023-07-07,0,2,2
1087664461,"LAFAYETTE, IN","LAFAYETTE, IN",2023-07-07,8,5,-3
1087688481,"MALLARD, AL","LOUISVILLE, KY",2023-07-07,0,1,1
3630161484,"VALDOSTA, GA","NEW ORLEANS, LA",2023-07-07,5,2,-3
3630151879,"EAST ST LOUIS, IL","BLUFFTON, IN",2023-07-07,11,9,-2
3630093534,"WADSWORTH, TX","ADEL, GA",2023-07-07,12,10,-2
3630091998,"MACON, GA","SAINT JOHN, NB",2023-07-07,8,6,-2
3630205597,"ROCKPORT, IN","MANSFIELD, OH",2023-07-07,2,1,-1
1087547601,"CHAPMAN, PA","BETHLEHEM, PA",2023-07-07,8,5,-3
3630207426,"MACMILLAN, AL","BELLMAWR, NJ",2023-07-07,6,6,0
3630104490,"MORAINE, OH","ALLEMANIA, LA",2023-07-07,7,9,2
1087694482,"ROANOKE, IN","LAWRENCEVILLE, GA",2023-07-07,5,2,-3
1087660116,"RUTHERFORD, PA","TITUSVILLE, FL",2023-07-07,-2,1,3
1087658193,"MUNCY (LVRR), PA","LORDSTOWN, OH",2023-07-07,9,9,0
1087653494,"LUDLOWVILLE (ITHR), NY","KNOXVILLE, TN",2023-07-07,0,2,2
1087546299,"AUSTELL, GA","CHICAGO, IL",2023-07-07,3,2,-1
3630171293,"YOUNGSTOWN, OH","NORTH BERGEN, NJ",2023-07-07,3,4,1
3630121492,"NORTH CHARLESTON, SC","FOREST PARK, GA",2023-07-07,7,4,-3
3630208896,"YORK, PA","MODESTO, CA",2023-07-07,1,3,2
3630157922,"BURNS HARBOR, IN","BURNS HARBOR, IN",2023-07-07,6,8,2
1087606154,"TOLEDO, OH","MIDDLETOWN, OH",2023-07-07,7,9,2
3630127464,"TOLEDO, OH","INDIANA HARBOR, IN",2023-07-07,0,2,2
3630092596,"BARSTOW, CA","CROXTON, NJ",2023-07-07,3,2,-1
1087555450,"JACKSONVILLE, FL","VOLTZ, MO",2023-07-07,2,3,1
3630062193,"WYLIE, TX","JACKSONVILLE, FL",2023-07-07,4,1,-3
3630171950,"PINE BLUFF, AR","KALAMAZOO, MI",2023-07-07,6,7,1
1087642558,"COLUMBUS, OH","CHICAGO, IL",2023-07-07,8,9,1
3630126573,"DILLEY, TX","PICAYUNE, MS",2023-07-02,5,3,-2
3628671693,"CHARLOTTE, NC","WHITE PIGEON, MI",2023-07-07,6,8,2
1087583144,"GARDNERS, PA","WESTVACO, WY",2023-07-07,9,10,1
3630171837,"LOS ANGELES, CA","AUSTELL, GA",2023-07-07,9,8,-1
3630158164,"BURNS HARBOR, IN","BURNS HARBOR, IN",2023-07-07,4,5,1
1087657333,"MAGNOLIA, GA","ROBERTA, AL",2023-07-07,12,10,-2
3630077538,"LOS ANGELES, CA","CROXTON, NJ",2023-07-07,6,3,-3
1087648588,"HARRISBURG, PA","CHICAGO, IL",2023-07-07,11,9,-2
3630133122,"SELKIRK, NY","BUFFALO, NY",2023-07-07,4,3,-1
3630075162,"NORTH CHARLESTON, SC","FOUNTAIN, AL",2023-07-07,10,8,-2
3630073673,"LOS ANGELES, CA","BALTIMORE, MD",2023-07-07,5,4,-1
1087603627,"OIL CITY, PA","LONGVIEW, TX",2023-07-07,5,7,2
1087558474,"LOS ANGELES, CA","CROXTON, NJ",2023-07-07,6,5,-1
3630085450,"MEMPHIS, TN","COATESVILLE, PA",2023-07-07,8,8,0
3630166206,"NATKA (AIKR), SC","LAKE CHARLES, LA",2023-07-07,5,5,0
3630153481,"SCIO, OH","EDDYSTONE, PA",2023-07-07,8,6,-2
3630128698,"BURNS HARBOR, IN","BURNS HARBOR, IN",2023-07-07,7,7,0
3630120941,"TOLEDO, OH","MIDDLETOWN, OH",2023-07-07,0,3,3
3630154534,"DECATUR, IL","BUTNER, NC",2023-07-07,4,6,2
1087605815,"MARTINSBURG, WV","LEETSDALE, PA",2023-07-07,1,2,1
1087544289,"ROSSER, GA","BARNESVILLE, GA",2023-07-07,2,4,2
1087630959,"SOUTH RALEIGH, NC","BESSEMER, AL",2023-07-07,6,8,2
1087688318,"ST GABRIEL, LA","PINEVILLE, NC",2023-07-07,1,4,3
3630159144,"BURNS HARBOR, IN","BURNS HARBOR, IN",2023-07-07,7,10,3
3630061464,"KANSAS CITY, MO","KANSAS CITY, MO",2023-07-07,1,2,1
3630069080,"ROSSER, GA","BARNESVILLE, GA",2023-07-07,5,4,-1
3630154291,"PT EVERGLADES, FL","BLAIR, NE",2023-07-07,2,3,1
3630175247,"SIMCO, ID","BERKELEY, MO",2023-07-07,7,6,-1
3630080086,"CALVERT, AL","INDIANA HARBOR, IN",2023-07-07,6,3,-3
1087537818,"MORRISVILLE TV, PA","CHICAGO ENGLEW TV, IL",2023-07-07,2,3,1
3630087216,"CANTONMENT, FL","SAVANNAH, GA",2023-07-07,7,6,-1
3630098186,"NORFOLK, VA","NORFOLK, VA",2023-07-07,6,8,2
3630063482,"LOS ANGELES, CA","CROXTON, NJ",2023-07-07,7,9,2
1087602142,"CHICAGO, IL","NORFOLK INTERNATION, VA",2023-07-07,13,10,-3
3630145195,"MELVINDALE, MI","KANSAS CITY, MO",2023-07-07,4,1,-3
1087581590,"CHICAGO, IL","CHARLOTTE, NC",2023-07-07,1,1,0
3630067533,"CALVERT, AL","WICHITA, KS",2023-07-07,8,6,-2
3630158017,"BURNS HARBOR, IN","BURNS HARBOR, IN",2023-07-07,4,2,-2
1087671418,"CHARLOTTE, NC","CEDAR CITY, UT",2023-07-07,2,3,1
1087689283,"CANNELTON (KNWA), WV","LAMBERTS POINT, VA",2023-07-07,2,5,3
1087639393,"DECATUR, IL","HOMER, IL",2023-07-07,3,5,2
1087533571,"ROSSVILLE, TN","RUTHERFORD, PA",2023-07-07,0,3,3
1087556545,"RANDOLPH, MO","ELIZABETHTOWN, KY",2023-07-07,2,2,0
3630068084,"ESCOBEDO, NL","CLEVELAND, OH",2023-07-07,5,5,0
3630104335,"MAGNOLIA, GA","ROBERTA, AL",2023-07-07,7,9,2
3630198198,"LAKE CHARLES, LA","ASHEBORO, NC",2023-07-07,6,8,2
3630191706,"NEW ORLEANS, LA","LORENZO, IL",2023-07-07,8,9,1
3630116934,"KANSAS CITY, MO","MELVINDALE, MI",2023-07-07,8,6,-2
3630126264,"KERNERSVILLE, NC","AUGUSTA, GA",2023-07-07,9,8,-1
1087586998,"COATESVILLE, PA","KOPPEL, PA",2023-07-07,8,8,0
3630049983,"TROUTVILLE, VA","SELMA, NC",2023-07-07,11,8,-3
1087615470,"DARROW, IL","LAFAYETTE, IN",2023-07-07,8,8,0
3630158813,"LORENZO, IL","TYNER, TN",2023-07-07,3,5,2
3630061008,"CHICAGO, IL","CINCINNATI, OH",2023-07-07,2,1,-1
3630166345,"DES MOINES, IA","DES MOINES, IA",2023-07-07,4,3,-1
3630092465,"WAYNESBURG, PA","BETHLEHEM, PA",2023-07-07,5,7,2
3630218914,"DUFFS JCT (POHC), PA","NARLO, OH",2023-07-07,11,10,-1
1087556553,"RANDOLPH, MO","ELIZABETHTOWN, KY",2023-07-07,9,10,1
1087632197,"CLEVELAND, OH","NORFOLK INTERNATION, VA",2023-07-07,0,3,3
1087693606,"CHARLOTTE, NC","LATHROP, CA",2023-07-07,0,1,1
1087583356,"CROXTON, NJ","DALLAS, TX",2023-07-07,5,4,-1
1087687744,"CLEVELAND, OH","COLUMBUS (CUOH), OH",2023-07-07,7,10,3
1087658389,"KANSAS CITY, MO","BETHINTERMODAL, PA",2023-07-07,-1,1,2
3630218867,"BARSTOW, CA","CROXTON, NJ",2023-07-07,2,5,3
3630137223,"LAMBERTS POINT, VA","WILLIAMSON YARD, WV",2023-07-07,6,4,-2
3630107579,"SANDUSKY DOCK, OH","CROOKED CREEK MINE, PA",2023-07-02,5,4,-1
3628671596,"CHARLOTTE, NC","WHITE PIGEON, MI",2023-07-07,0,2,2
3630218752,"YORK, PA","EAST ST LOUIS, IL",2023-07-07,8,6,-2
3630064705,"MERIDIAN, MS","AUSTELL INTERMODAL, GA",2023-07-07,6,4,-2
1087562782,"CITY OF INDUSTRY, CA","GREENSBORO, NC",2023-07-07,8,10,2
3630107951,"DALTON, GA","FORMOSA, TX",2023-07-07,3,3,0
3630206129,"MELVINDALE, MI","KANSAS CITY, MO",2023-07-07,7,5,-2
3630175849,"COLLEGE PARK, GA","NORTH CHATTANOOGA, TN",2023-07-06,1,3,2
1087460655,"WINSTON-SALEM, NC","WHITE PIGEON, MI",2023-07-07,3,6,3
3630144547,"EAST POINT, GA","BREWTON, AL",2023-07-07,4,5,1
3630160349,"LYONS, PA","CITY OF INDUSTRY, CA",2023-07-07,3,3,0
1087521647,"CAROL, IN","FRANCISCO, IN",2023-07-07,7,5,-2
3630186094,"MACON, GA","MACON, GA",2023-07-07,0,3,3
3630149050,"DECATUR, IL","DECATUR, IL",2023-07-07,7,6,-1
3630167993,"BRUNSWICK, GA","ARMSTRONG, GA",2023-07-07,4,2,-2
3630082680,"CALVERT, AL","INDIANA HARBOR, IN",2023-07-07,-1,2,3
3630097732,"LOS ANGELES, CA","AUSTELL, GA",2023-07-07,5,4,-1
3630154584,"LUDLOWVILLE (ITHR), NY","SHELBURNE, VT",2023-07-07,10,7,-3
3630095366,"GATEWAY MINE, IL","WHEATFIELD, IN",2023-07-07,6,5,-1
1087622859,"BOWDEN YARD, FL","CHICAGO 47TH ST TV, IL",2023-07-07,1,3,2
3630052473,"BLUFFTON, IN","SELMA, NC",2023-07-07,7,8,1
3630195700,"RALEIGH, NC","ROBERTA, AL",2023-07-07,0,2,2
3630097122,"ERIE, PA","JERSEY, TN",2023-07-07,1,2,1
1087678096,"PRENTISS, AB","MCDONOUGH, GA",2023-07-07,7,9,2
3630175920,"REIDSVILLE, NC","LEMOYNE, AL",2023-07-07,6,5,-1
1087596765,"DETROIT, MI","PORTSMOUTH APMT, VA",2023-07-07,5,3,-2
3630147870,"STREATOR, IL","KINGSPORT, TN",2023-07-07,7,9,2
3630155815,"ICTF, CA","GEORGETOWN, KY",2023-07-07,12,9,-3
3630079695,"LOS ANGELES, CA","AUSTELL, GA",2023-07-07,7,4,-3
3630156154,"ELDON, TX","CLINTON (KXCG), TN",2023-07-07,-2,1,3
3630177477,"ASHEVILLE, NC","MARYLAND, LA",2023-07-07,7,10,3
3630066464,"CLEARING CHGO, IL","CHICAGO, IL",2023-07-07,9,7,-2
3630085298,"LOS ANGELES, CA","CROXTON, NJ",2023-07-07,0,2,2
3630062428,"LAMBERTS POINT, VA","WILLIAMSON YARD, WV",2023-07-07,6,6,0
1087640069,"MOREHEAD CITY, NC","DECOURSEY, KY",2023-07-07,9,8,-1
3630139754,"DECATUR, IL","HAPEVILLE, GA",2023-07-07,2,5,3
3630057693,"LONG BEACH E PIER, CA","CINCINNATI, OH",2023-07-07,6,4,-2
3630095007,"GATEWAY MINE, IL","WHEATFIELD, IN",2023-07-07,5,6,1
3630098356,"NEW BERN, NC","BURNSVILLE, MS",2023-07-07,12,10,-2
1087576040,"MEMPHIS, TN","JACKSONVILLE, FL",2023-07-07,11,9,-2
1087523283,"BLUFFTON, IN","SELMA, NC",2023-07-07,12,10,-2
3630068539,"CHICAGO, IL","COLUMBUS, OH",2023-07-07,3,4,1
3630142668,"DAVISVILLE, RI","LAFAYETTE, IN",2023-07-07,7,5,-2
3630148266,"MONTGOMERY, NY","HANNA, OH",2023-07-02,11,9,-2
3628723157,"LAMBERTS POINT, VA","TOMS CREEK, VA",2023-07-07,7,5,-2
3630190221,"WILLIAMSPORT, PA","MILL CREEK, OK",2023-07-07,11,8,-3
3630158790,"BURNS HARBOR, IN","BURNS HARBOR, IN",2023-07-07,13,10,-3
1087597533,"ROSSVILLE, TN","RUTHERFORD, PA",2023-07-07,4,7,3
3630080523,"HYCO, NC","BAILEY MINE, PA",2023-07-07,5,3,-2
1087609665,"CAMP HILL, PA","ARKANSAS CITY, KS",2023-07-07,8,6,-2
3630194681,"FARMERS VALLEY, PA","BAYTOWN, TX",2023-07-07,8,8,0
3630132972,"SELKIRK, NY","BUFFALO, NY",2023-07-07,6,5,-1
1087578000,"GATEWAY MINE, IL","WHEATFIELD, IN",2023-07-07,1,2,1
3630097839,"LOS ANGELES, CA","CROXTON, NJ",2023-07-07,5,7,2
3630173889,"FLORENCE JCT, VT","WEST POINT, VA",2023-07-07,8,7,-1
3630181955,"MIDWEST PORTAGE, IN","GARY, IN",2023-07-07,2,4,2
3630199788,"CEDAR RAPIDS, IA","CITY POINT, FL",2023-07-07,0,1,1
3630117524,"GEORGETOWN, KY","OLD OCEAN, TX",2023-07-07,9,8,-1
3630129204,"PAULSBORO, NJ","TUCKAHOE, NJ",2023-07-07,5,2,-3
3630091736,"LATHROP, CA","AUSTELL, GA",2023-07-04,8,9,1
1086406111,"SANDUSKY DOCK, OH","CROOKED CREEK MINE, PA",2023-07-07,2,1,-1
1087672668,"MILLVILLE, NJ","PAVONIA, NJ",2023-07-07,0,1,1
3630097651,"TAYLOR, PA","SCHENECTADY, NY",2023-07-07,7,6,-1
3630184026,"PRENTISS, AB","MCDONOUGH, GA",2023-07-07,1,2,1
1087598034,"LANDERS, IL","CICERO, IL",2023-07-07,4,2,-2
3630073241,"CLINTON, IA","MASCOT, TN",2023-07-07,10,10,0
1087540578,"DET JEFFERSON, MI","ROLLA, CO",2023-07-07,-1,1,2
1087674660,"LAFAYETTE, GA","JACKSONVILLE, AR",2023-07-07,-1,1,2
3630055984,"MERIDIAN, MS","CHARLOTTE, NC",2023-07-07,11,8,-3
3630175865,"COLLEGE PARK, GA","NORTH CHATTANOOGA, TN",2023-07-07,3,4,1
3630080549,"HYCO, NC","BAILEY MINE, PA",2023-07-07,3,4,1
1087625611,"CLEVELAND WEST PARK, OH","CLEVELAND, OH",2023-07-07,9,6,-3
3630078869,"DES MOINES, IA","DECATUR, IL",2023-07-07,4,7,3
3630188452,"TACOMA EXPORT, WA","COLUMBUS, OH",2023-07-07,3,1,-2
3630205717,"WARRENTON, OH","SPARTA, WI",2023-07-07,5,5,0
3630145878,"LAMBERTS POINT, VA","WILLIAMSON YARD, WV",2023-07-07,0,1,1
3630067630,"ZACHA JCT, TX","DELTA, OH",2023-07-07,5,7,2
1087548445,"LOS ANGELES, CA","RUTHERFORD, PA",2023-07-07,3,1,-2
1087605247,"GIBBSTOWN, NJ","SCIO, OH",2023-07-07,11,10,-1
3630111219,"SLCIT, UT","AUSTELL, GA",2023-07-07,6,8,2
3630056168,"MERIDIAN, MS","JACKSONVILLE, FL",2023-07-07,3,1,-2
3630213011,"MUNCY (LVRR), PA","CLAYTON (DCR), DE",2023-07-04,11,8,-3
3629138737,"SANDUSKY DOCK, OH","CROOKED CREEK MINE, PA",2023-07-07,6,8,2
1087702277,"SPARTANBURG, SC","SHARON, TN",2023-07-07,1,3,2
3630082460,"CALVERT, AL","INDIANA HARBOR, IN",2023-07-07,5,4,-1
3630180103,"SHENANDOAH, PA","MINNEQUA, CO",2023-07-07,2,5,3
1087612781,"EDGERTON, IN","KINGS CREEK (DCR), MD",2023-07-02,8,7,-1
3628723319,"LAMBERTS POINT, VA","TOMS CREEK, VA",2023-07-07,3,2,-1
1087575743,"MEMPHIS, TN","CHARLOTTE, NC",2023-07-07,-1,1,2
1087700152,"POSTELL, GA","PANAMA CITY, FL",2023-07-07,0,1,1
3630193897,"ST GABRIEL, LA","HUNTERSVILLE, NC",2023-07-07,10,10,0
3630087119,"KANSAS CITY, MO","MELVINDALE, MI",2023-07-07,8,6,-2
1087675488,"SELKIRK, NY","LAFAYETTE, IN",2023-07-07,4,4,0
3630162414,"LACYMARK, FL","JUNCTION CITY, GA",2023-07-07,3,6,3
3630149335,"CEDAR CITY, UT","CHARLOTTE, NC",2023-07-07,8,8,0
3630176950,"DISCOVERY PARK, OH","DISCOVERY PARK, OH",2023-07-07,4,3,-1
3630152095,"KEOKUK, IA","ALTOONA, PA",2023-07-07,10,7,-3
3630156138,"ELDON, TX","FAIRCHANCE, PA",2023-07-07,6,3,-3
3630114102,"LOS ANGELES, CA","RUTHERFORD, PA",2023-07-07,9,10,1
3630177273,"BURLEY, ID","MASSILLON, OH",2023-07-07,9,6,-3
3630184725,"MELVINDALE, MI","KANSAS CITY, MO",2023-07-07,6,4,-2
3630194738,"FARMERS VALLEY, PA","WOODS CROSS, UT",2023-07-07,11,10,-1
3630155920,"ICTF, CA","GEORGETOWN, KY",2023-07-07,1,3,2
3630080565,"HYCO, NC","BAILEY MINE, PA",2023-07-07,4,7,3
1087599666,"CROXTON, NJ","LOS ANGELES, CA",2023-07-07,5,2,-3
3630052229,"BLUFFTON, IN","SELMA, NC",2023-07-07,4,1,-3
3630126947,"BAYPORT, TX","FINDERNE, NJ",2023-07-07,6,3,-3
1087531016,"BELLEVUE, OH","BELLEVUE, OH",2023-07-07,11,9,-2
3630151714,"MELVINDALE, MI","KANSAS CITY, MO",2023-07-07,8,5,-3
3630130792,"MANSFIELD, OH","ELKIN, NC",2023-07-07,1,1,0
1087668261,"COLLEGE PARK, GA","NORTH CHATTANOOGA, TN",2023-07-07,4,4,0
3630088000,"BOWDEN YARD, FL","POSTELL, GA",2023-07-07,6,8,2
3630150954,"DECATUR, IL","HOMER, IL",2023-07-07,11,8,-3
1087529776,"ST LOUIS, MO","PORTSMOUTH APMT, VA",2023-07-07,6,6,0
3630187286,"OAKWOOD, MI","ENCANTADA, CU",2023-07-07,9,7,-2
3630158863,"BURNS HARBOR, IN","BURNS HARBOR, IN",2023-07-07,10,8,-2
3630188729,"GREER, SC","PLAQUEMINE, LA",2023-07-07,9,9,0
1087526493,"UNIONTOWN, AL","UNIONTOWN, AL",2023-07-07,5,2,-3
1087529491,"LAMBERTS POINT, VA","WILLIAMSON YARD, WV",2023-07-07,5,5,0
1087639084,"CHOCOLATE BAYOU, TX","DECATUR, AL",2023-07-07,4,4,0
1087664500,"MARCUS, IA","ATLANTA, GA",2023-07-07,7,5,-2
1087645378,"AUSTELL, GA","LOS ANGELES, CA",2023-07-07,1,4,3
3630141963,"BENTONITE, WY","OLD FORT, OH",2023-07-07,2,3,1
1087610967,"KANSAS CITY, MO","MELVINDALE, MI",2023-07-07,11,10,-1
1087564417,"CALVERT CITY, KY","EMORY GAP, TN",2023-07-02,6,8,2
3628751590,"LAMBERTS POINT, VA","TOMS CREEK, VA",2023-07-07,9,8,-1
3630117134,"ROSSVILLE, TN","ROSSVILLE, TN",2023-07-07,6,4,-2
3630159160,"WEIRTON, WV","BURNS HARBOR, IN",2023-07-07,4,1,-3
3630189220,"MELVINDALE, MI","KANSAS CITY, MO",2023-07-07,5,6,1
3630157435,"PAINESVILLE, OH","INSTITUTE (KNWA), WV",2023-07-07,8,8,0
3630072473,"SAN BERNARDINO, CA","CHARLOTTE, NC",2023-07-07,8,6,-2
3630216768,"CLAY, DE","HANNA, OH",2023-07-07,3,3,0
3630157485,"BURNS HARBOR, IN","BURNS HARBOR, IN",2023-07-07,4,2,-2
1087595078,"OAKWOOD, MI","OAKWOOD, MI",2023-07-06,12,10,-2
3629870965,"LAMBERTS POINT, VA","TOMS CREEK, VA",2023-07-07,4,7,3
3630177613,"RUEBEL, MN","STUARTS DRAFT, VA",2023-07-07,6,6,0
1087546176,"TOLEDO, OH","BUFFALO, NY",2023-07-07,6,9,3
3630161620,"LAMBERTS POINT, VA","WILLIAMSON YARD, WV",2023-07-07,6,9,3
1087683782,"LITTLETON, MA","DECATUR, AL",2023-07-07,2,5,3
3630171358,"BRUNSWICK, GA","LOZETA, MO",2023-07-07,5,4,-1
3630148795,"NEW ORLEANS, LA","CINCINNATI, OH",2023-07-07,9,6,-3
3630209478,"BAYWAY, NJ","CHICAGO, IL",2023-07-07,7,4,-3
1087522457,"AUSTELL INTERMODAL, GA","KANSAS CITY, MO",2023-07-07,7,9,2
3630092326,"WAYNESBURG, PA","BETHLEHEM, PA",2023-07-07,8,5,-3
1087525900,"ST LOUIS, MO","RUTHERFORD, PA",2023-07-07,7,9,2
3630159063,"BURNS HARBOR, IN","BURNS HARBOR, IN",2023-07-07,0,1,1
1087575175,"WAYNESBURG, PA","BETHLEHEM, PA",2023-07-07,12,10,-2
3630093720,"MEMPHIS, TN","CHARLOTTE, NC",2023-07-07,4,4,0
1087609607,"OLD FORT, OH","ALCHEM, WY",2023-07-07,4,4,0
3630108290,"VALDOSTA, GA","BURNSVILLE, MS",2023-07-07,5,6,1
3630090049,"MERIDIAN, MS","AUSTELL, GA",2023-07-05,6,9,3
3629428881,"LAMBERTS POINT, VA","TOMS CREEK, VA",2023-07-07,4,2,-2
3630154623,"LUDLOWVILLE (ITHR), NY","SHELBURNE, VT",2023-07-07,4,1,-3
1087643627,"COLUMBUS, OH","BUTLER, IN",2023-07-07,10,7,-3
3630097229,"WINSTON-SALEM, NC","DECATUR, IL",2023-07-07,0,1,1
3630170661,"AYER, MA","DECATUR, IN",2023-07-07,8,10,2
3630064674,"MERIDIAN, MS","AUSTELL INTERMODAL, GA",2023-07-07,1,4,3
3630181824,"SELKIRK, NY","LAFAYETTE, IN",2023-07-06,5,6,1
3630015968,"LAMBERTS POINT, VA","TOMS CREEK, VA",2023-07-07,11,9,-2
3630080345,"HYCO, NC","BAILEY MINE, PA",2023-07-07,7,10,3
1087644186,"CLAVET, SK","GAINESVILLE, GA",2023-07-07,3,4,1
1087716284,"DECATUR, AL","CLARE, MI",2023-07-07,7,10,3
1087629835,"LOGISTICS PARK CHIC, IL","CHICAGO, IL",2023-07-05,7,6,-1
1086774522,"LAMBERTS POINT, VA","TOMS CREEK, VA",2023-07-07,4,2,-2
1087568128,"SHELBURNE, VT","LUDLOWVILLE (ITHR), NY",2023-07-07,-2,1,3
3630112914,"CHARLESTON, SC","EAST CHICAGO, IN",2023-07-07,5,7,2
3630156324,"DALLAS, TX","HARRISBURG, PA",2023-07-07,9,6,-3
1087703223,"NEW HAVEN, IN","OAKWOOD, GA",2023-07-07,13,10,-3
3630219588,"CATAWBA, SC","SANTA CATARINA, NL",2023-07-07,5,2,-3
3630156285,"CARROLL, TN","ROANOKE, VA",2023-07-07,10,7,-3
1087606471,"WYLIE, TX","ATLANTA, GA",2023-07-07,12,10,-2
3630063157,"PANZACOLA, TL","CALVERT, AL",2023-07-07,8,7,-1
3630172118,"BECANCOUR, PQ","DETROIT, MI",2023-07-07,2,1,-1
3630091320,"WINSTON-SALEM, NC","WHITE PIGEON, MI",2023-07-07,5,2,-3
3630074823,"NEW ORLEANS, LA","ANDERSON (PKHP), SC",2023-07-07,3,3,0
3630120967,"TOLEDO, OH","MIDDLETOWN, OH",2023-07-07,6,5,-1
3630098526,"NORFOLK, VA","NORFOLK, VA",2023-07-07,9,6,-3
3630063458,"WYLIE, TX","ATLANTA, GA",2023-07-07,4,5,1
3630117079,"ROSSVILLE, TN","ROSSVILLE, TN",2023-07-07,4,3,-1
1087667168,"LIMA, OH","MAUMEE, OH",2023-07-07,9,6,-3
3630182197,"SELKIRK, NY","LAFAYETTE, IN",2023-07-07,7,9,2
1087542952,"CHARLOTTE INTER, NC","SAN BERNARDINO, CA",2023-07-07,7,9,2
3630197249,"WINNEBAGO, MN","MACUNGIE, PA",2023-07-07,7,9,2
3630172029,"PINE BLUFF, AR","WAYNESVILLE (BLU), NC",2023-07-07,6,9,3
1087609479,"LEWISTOWN, PA","ROSSER, GA",2023-07-03,8,6,-2
3628888486,"WINSTON-SALEM, NC","WHITE PIGEON, MI",2023-07-07,6,4,-2
1087531707,"BELLEVUE, OH","BELLEVUE, OH",2023-07-07,5,7,2
1087627647,"BROWNSON, AL","GYPSUM, OH",2023-07-07,7,8,1
3630058801,"LONG BEACH E PIER, CA","COLUMBUS, OH",2023-07-07,7,10,3
3630068424,"CHICAGO, IL","CROXTON, NJ",2023-07-07,0,3,3
1087663928,"NEW ORLEANS, LA","BIRMINGHAM, AL",2023-07-07,-1,1,2
1087689144,"CANNELTON (KNWA), WV","LAMBERTS POINT, VA",2023-07-07,0,3,3
3630172215,"LATC, CA","MORRISVILLE, PA",2023-07-07,4,3,-1
3630092449,"WAYNESBURG, PA","BETHLEHEM, PA",2023-07-07,5,3,-2
3630195475,"PORT HURON, MI","POOLER, GA",2023-07-07,3,3,0
1087676638,"NORFOLK INTERNATION, VA","LANDERS, IL",2023-07-07,-1,2,3
1087624657,"WEIRTON, WV","FAIRLESS, PA",2023-07-07,4,7,3
1087637286,"NORTH BIRMINGHAM, AL","MOBILE, AL",2023-07-07,4,2,-2
1087563990,"CALVERT CITY, KY","EMORY GAP, TN",2023-07-07,4,6,2
3630132011,"UNION BRIDGE, MD","NORFOLK, VA",2023-07-07,0,1,1
3630100399,"LEESBURG, OH","BATON ROUGE, LA",2023-07-07,0,2,2
3630205018,"POSTELL, GA","ELLABELL, GA",2023-07-07,3,5,2
3630199681,"CEDAR RAPIDS, IA","MECHANICSBURG, PA",2023-07-07,10,8,-2
3630193106,"MAIDSVILLE, WV","WINSLOW, IN",2023-07-07,4,7,3
3630118570,"CRESSON, PA","CLEVELAND, OH",2023-07-07,5,5,0
1087645467,"MELVINDALE, MI","LIVERNOIS, MI",2023-07-07,5,6,1
1087700631,"POSTELL, GA","ODUM, GA",2023-07-07,9,8,-1
3630103795,"GARY, WV","AUGUSTA, GA",2023-07-07,12,9,-3
3630151057,"DECATUR, IL","HOMER, IL",2023-07-07,2,5,3
1087683237,"TACOMA EXPORT, WA","COLUMBUS, OH",2023-07-07,1,1,0
1087553270,"LOS ANGELES, CA","CROXTON, NJ",2023-07-07,12,10,-2
3630217023,"KNOXVILLE, TN","SCIO, OH",2023-07-07,11,8,-3
1087526053,"AUSTELL, GA","SAN BERNARDINO, CA",2023-07-07,2,1,-1
1087706093,"MAHRT (CCH), AL","PORT WENTWORTH, GA",2023-07-07,2,1,-1
1087658664,"ZORRA, ON","SIEGFRIED, PA",2023-07-07,4,7,3
3630110899,"MIAMI, FL","VALDOSTA, GA",2023-07-07,3,3,0
3630117184,"MORRISTOWN, TN","CHICAGO, IL",2023-07-07,2,3,1
3630086252,"PRINCETON, IN","BENICIA, CA",2023-07-07,7,8,1
1087571579,"NEW ORLEANS, LA","CHALMETTE, LA",2023-07-07,8,9,1
3630145658,"BIRMINGHAM, MO","DETROIT DEARBORN, MI",2023-07-07,0,3,3
1087715628,"BARSTOW, CA","CROXTON, NJ",2023-07-07,2,2,0
3630214025,"TAYLOR, PA","BALTIMORE TERMINAL, MD",2023-07-07,7,10,3
1087539006,"ROJAS, CU","MELVINDALE, MI",2023-07-07,4,3,-1
3630211603,"OAKLAND CITY JCT, IN","MAHRT (CCH), AL",2023-07-07,5,4,-1
3630124204,"LEMOYNE, AL","NEW ORLEANS, LA",2023-07-07,4,1,-3
1087585243,"ANNVILLE, PA","FELTON (DCR), DE",2023-07-07,3,5,2
3630210330,"LOS ANGELES, CA","CHARLOTTE, NC",2023-07-07,-1,2,3
3630087826,"JACKSONVILLE, FL","PRINCETON, IN",2023-07-07,5,3,-2
1087540625,"DET JEFFERSON, MI","ROLLA, CO",2023-07-07,10,8,-2
3630080206,"HYCO, NC","BAILEY MINE, PA",2023-07-07,4,4,0
1087547669,"LOS ANGELES, CA","JACKSONVILLE, FL",2023-07-07,4,7,3
3630072229,"LOS ANGELES, CA","BALTIMORE, MD",2023-07-07,8,8,0
3630163177,"CHICAGO, IL","CHICAGO MIX CTR, IL",2023-07-07,3,1,-2
1087660344,"CHICAGO 47TH ST TV, IL","BETHINTERMODAL, PA",2023-07-07,6,6,0
3630193504,"WARRICK, IN","ARVIDA, PQ",2023-07-07,2,3,1
3630210380,"LOS ANGELES, CA","CHARLOTTE, NC",2023-07-07,2,2,0
3630163313,"OAKLAND, CA","NORFOLK INTERNATION, VA",2023-07-07,9,6,-3
3630173562,"WILMINGTON, CA","PORT NEWARK ELIZABE, NJ",2023-07-07,6,9,3
1087616701,"BURNS HARBOR, IN","BURNS HARBOR, IN",2023-07-07,5,6,1
3630119518,"MACMILLAN, AL","TIPTON, IN",2023-07-07,7,6,-1
3630148541,"DECATUR, AL","HARRISONVILLE, MO",2023-07-07,9,10,1
3630109050,"TERRE HAUTE, IN","FARRELL, PA",2023-07-07,9,7,-2
3630052198,"BLUFFTON, IN","SELMA, NC",2023-07-07,0,1,1
3630104555,"MIAMI, FL","CHICAGO 47TH ST TV, IL",2023-07-07,5,8,3
3630058128,"LONG BEACH E PIER, CA","CINCINNATI, OH",2023-07-07,8,6,-2
1087634678,"SHARONVILLE, OH","SHARONVILLE, OH",2023-07-07,5,4,-1
3630076621,"STOCKTON IMF, CA","JACKSONVILLE, FL",2023-07-07,10,8,-2
3630090007,"MERIDIAN, MS","JACKSONVILLE, FL",2023-07-07,10,10,0
3630162074,"KANSAS CITY, MO","MELVINDALE, MI",2023-07-07,3,5,2
3630062169,"BELLEVUE, OH","BELLEVUE, OH",2023-07-07,5,5,0
1087627508,"DECATUR, IL","MORRISVILLE, PA",2023-07-07,7,4,-3
1087676078,"MIDWEST PORTAGE, IN","GARY, IN",2023-07-07,7,5,-2
3630132752,"SELKIRK, NY","BUFFALO, NY",2023-07-07,2,3,1
3630117639,"BAUXITE, AR","LEETSDALE, PA",2023-07-07,6,6,0
1087679547,"AVON LAKE, OH","AYER, MA",2023-07-07,6,8,2
3630218257,"DUFFS JCT (POHC), PA","JONESBURG, MO",2023-07-07,4,5,1
1087619393,"SELKIRK, NY","BUFFALO, NY",2023-07-03,3,4,1
3629125734,"SANDUSKY DOCK, OH","CROOKED CREEK MINE, PA",2023-07-07,6,3,-3
3630158708,"GREER, SC","CHARLESTON, SC",2023-07-07,7,4,-3
3630166036,"EMIGSVILLE, PA","WARDEN, WA",2023-07-07,5,8,3
3630092415,"WAYNESBURG, PA","BETHLEHEM, PA",2023-07-07,1,2,1
3630179584,"JACKSONVILLE, FL","MEMPHIS, TN",2023-07-07,7,8,1
3630108096,"FARRELL, PA","PAULSBORO, NJ",2023-07-07,4,7,3
3630049991,"TROUTVILLE, VA","SELMA, NC",2023-07-07,7,6,-1
3630060727,"CHICAGO, IL","TOLEDO, OH",2023-07-07,0,1,1
1087577907,"GATEWAY MINE, IL","WHEATFIELD, IN",2023-07-07,6,9,3
3630159607,"NEW ORLEANS, LA","FT VALLEY, GA",2023-07-06,4,4,0
3629821152,"SURRENCY, GA","ANDERSON (ICRK), IN",2023-07-07,-1,2,3
3630182406,"SANDERSVILLE, GA","EAGLE MILLS, MI",2023-07-07,9,8,-1
1087632731,"BAYARD, FL","MODESTO, CA",2023-07-07,11,9,-2
3630146387,"WOOSTER, OH","BROWNSTOWN, MI",2023-07-07,12,9,-3
1087542261,"GEORGETOWN, KY","COMMERCE, GA",2023-07-07,2,2,0
3630197671,"NORTH BIRMINGHAM, AL","SPOCARI, AL",2023-07-07,3,4,1
3630172095,"LOS ANGELES, CA","HARRISBURG, PA",2023-07-06,6,7,1
1087329532,"NORFOLK, VA","LIVERNOIS, MI",2023-07-07,5,4,-1
1087693711,"SANDERSVILLE, GA","FERNLEY, NV",2023-07-07,8,5,-3
1087663635,"PINE BLUFF, AR","PARADISE VALLEY (AB, GA",2023-07-07,10,10,0
1087566825,"CHICAGO, IL","NORFOLK, VA",2023-07-07,7,4,-3
3630146866,"MIAMI, FL","CHICAGO 47TH ST TV, IL",2023-07-07,5,6,1
3630186329,"HAMILTON, ON","KIRKWOOD, NY",2023-07-07,8,5,-3
3630087795,"JACKSONVILLE, FL","PRINCETON, IN",2023-07-07,2,5,3
3630093623,"GARY, IN","MIDWEST PORTAGE, IN",2023-07-07,12,10,-2
3630208024,"WYLIE, TX","JACKSONVILLE, FL",2023-07-07,4,2,-2
3630182600,"SANDERSVILLE, GA","SOLVAY, WY",2023-07-07,5,4,-1
3630108038,"LOS ANGELES, CA","COLUMBUS, OH",2023-07-07,6,5,-1
3630212829,"WINSTON-SALEM, NC","HOBBS, IN",2023-07-07,8,6,-2
1087616248,"UNION BRIDGE, MD","DURHAM, NC",2023-07-07,8,9,1
3630086121,"SAN BERNARDINO, CA","JACKSONVILLE, FL",2023-07-07,3,5,2
3630123575,"NEVILLE ISLAND, PA","ANNAWAN, IL",2023-07-07,3,3,0
1087533204,"CLEVELAND, OH","MIDWEST PORTAGE, IN",2023-07-07,7,9,2
1087548770,"CANTON, OH","DYER, PA",2023-07-07,5,4,-1
3630055227,"AMARILLO, TX","KAOLIN, GA",2023-07-07,9,6,-3
1087690030,"CANNELTON (KNWA), WV","LAMBERTS POINT, VA",2023-07-07,1,3,2
3630187147,"DECATUR, AL","DECATUR, AL",2023-07-07,10,10,0
3630171188,"YOUNGSTOWN, OH","LAMAR, CO",2023-07-07,1,3,2
1087608986,"NEVILLE ISLAND, PA","ANNAWAN, IL",2023-07-07,3,1,-2
3630091922,"MACON, GA","SAINT JOHN, NB",2023-07-07,10,8,-2
3630090065,"MERIDIAN, MS","AUSTELL, GA",2023-07-07,9,8,-1
3630060963,"CHICAGO, IL","CINCINNATI, OH",2023-07-07,6,6,0
3630060769,"CHICAGO, IL","TOLEDO, OH",2023-07-07,12,9,-3
3630092635,"TULSA, OK","SHEFFIELD, AL",2023-07-07,7,7,0
3630110881,"MIAMI, FL","FRANKFORT, IN",2023-07-07,4,7,3
1087540104,"DECATUR, IL","CAREY, OH",2023-07-07,8,8,0
3630086919,"KANSAS CITY, MO","MELVINDALE, MI",2023-07-07,4,4,0
1087654686,"MIDWEST PORTAGE, IN","GEORGETOWN, KY",2023-07-07,5,8,3
1087645695,"CLAYPOOL, IN","MECHANICSBURG, PA",2023-07-07,11,8,-3
1087557119,"CICERO, IL","HARRISBURG, PA",2023-07-07,7,7,0
3630186612,"SAIT, TX","TOLEDO, OH",2023-07-07,1,2,1
1087588623,"ROGERSLACY, MS","NAMPA, AB",2023-07-07,8,8,0
1087654783,"GENEVA, NY","MAPLETON, PA",2023-07-07,-1,2,3
3630068880,"COLUMBUS, GA","STE GENEVIEVE, MO",2023-07-07,7,4,-3
3630178855,"ATLANTA, GA","ATLANTA, GA",2023-07-07,2,2,0
3630144610,"OPTIMA, OK","DECATUR, IL",2023-07-02,-2,1,3
3628756477,"CAROL, IN","FRANCISCO, IN",2023-07-07,11,8,-3
3630158669,"BURNS HARBOR, IN","BURNS HARBOR, IN",2023-07-07,5,3,-2
1087581304,"BOLIVAR, OH","OLD OCEAN, TX",2023-07-07,7,6,-1
1087619903,"SELKIRK, NY","BUFFALO, NY",2023-07-07,3,1,-2
1087530793,"BELLEVUE, OH","BELLEVUE, OH",2023-07-07,6,9,3
3630068220,"CHICAGO, IL","RUTHERFORD, PA",2023-07-07,5,7,2
3630112817,"CHARLESTON, SC","EAST CHICAGO, IN",2023-07-07,5,8,3
3630203511,"LAMBERTS POINT, VA","TOMS CREEK, VA",2023-07-07,6,7,1
3630203977,"PLANT CITY, FL","JACKSONVILLE, FL",2023-07-07,9,8,-1
3630066943,"LOS ANGELES, CA","RUTHERFORD, PA",2023-07-07,8,8,0
3630199893,"ROBERTS BANK, BC","CLEVELAND, OH",2023-07-07,8,7,-1
3630185242,"GARY, IN","MIDWEST PORTAGE, IN",2023-07-07,2,1,-1
1087575345,"NORFOLK, VA","ST LOUIS, MO",2023-07-07,3,6,3
3630128965,"GARLAND, TX","ASHEBORO, NC",2023-07-07,2,2,0
1087688067,"SALTILLO, MS","HOPEWELL, VA",2023-07-07,6,9,3
3630174144,"AUGUSTA, GA","MIAMI, FL",2023-07-07,5,4,-1
3630128232,"BURNS HARBOR, IN","BURNS HARBOR, IN",2023-07-07,3,3,0
1087602809,"SAINT JOHN, NB","MACON, GA",2023-07-07,7,7,0
3630179534,"RUEBEL, MN","CHICAGO, IL",2023-07-07,8,8,0
3630129458,"SOUTH AMERICUS, GA","SYLVITE, SK",2023-07-07,11,8,-3
3630068709,"CHICAGO, IL","COLUMBUS, OH",2023-07-07,7,7,0
3630072300,"LAGRANGE, NL","STERLING HEIGHTS, MI",2023-07-07,3,4,1
3630180828,"CHICAGO, IL","LEXINGTON, KY",2023-07-07,7,6,-1
3630208985,"MAHANOY CITY, PA","WORLAND, WY",2023-07-07,3,1,-2
1087552800,"LOS ANGELES, CA","JACKSONVILLE, FL",2023-07-07,9,7,-2
3630064080,"SAGUENAY POWER, PQ","ALCOA, TN",2023-07-07,12,10,-2
3630070683,"BARSTOW, CA","HARRISBURG, PA",2023-07-07,3,1,-2
3630072546,"LAGRANGE, NL","STERLING HEIGHTS, MI",2023-07-07,1,2,1
3630124220,"STEARNS, KY","CHATTANOOGA, TN",2023-07-07,4,7,3
3630127472,"TOLEDO, OH","INDIANA HARBOR, IN",2023-07-07,2,3,1
3630092805,"RINCON, GA","BROOKLAWN, LA",2023-07-07,9,6,-3
1087714850,"LAKEVILLE, NY","KINGS CREEK (DCR), MD",2023-07-07,2,5,3
1087652935,"BLANCHESTER, OH","WAYNESBORO, MS",2023-07-07,7,8,1
3630219619,"FINDERNE, NJ","LONGVIEW, TX",2023-07-07,10,8,-2
3630068204,"CHICAGO, IL","CROXTON, NJ",2023-07-07,2,4,2
1087682312,"LAFAYETTE, IN","VERNON, CA",2023-07-07,10,9,-1
1087604526,"MARCUS HOOK, PA","STONY CREEK, PA",2023-07-07,10,8,-2
3630081228,"CALVERT, AL","INDIANA HARBOR, IN",2023-07-07,7,7,0
1087549019,"CANTON, OH","DYER, PA",2023-07-07,3,2,-1
1087654547,"MERIDIAN, MS","ATLANTA, GA",2023-07-07,5,2,-3
1087631492,"WYLIE, TX","RUTHERFORD, PA",2023-07-07,6,5,-1
3630116421,"PORTLAND, OR","AUSTELL, GA",2023-07-07,4,7,3
1087616612,"BETHINTERMODAL, PA","LATHROP, CA",2023-07-07,2,1,-1
1087654806,"GENEVA, NY","MAPLETON, PA",2023-07-07,1,2,1
3630134372,"WYLIE, TX","TITUSVILLE, FL",2023-07-07,7,4,-3
1087666560,"PERRY, OH","PERRY, OH",2023-07-07,2,2,0
1087547758,"CLEBURNE, TX","CHESAPEAKE, VA",2023-07-07,7,8,1
1087643601,"COLUMBUS, OH","BUTLER, IN",2023-07-07,0,2,2
1087583013,"CLAY, DE","THOMASTON, IN",2023-07-07,4,4,0
1087611400,"BURNS HARBOR, IN","COATESVILLE, PA",2023-07-07,1,3,2
3630166434,"BRILLS, NJ","NEW LEXINGTON (OSRR, OH",2023-07-07,3,3,0
1087690535,"SINKING SPRING, PA","DYERSVILLE, IA",2023-07-07,-1,1,2
1087530638,"BELLEVUE, OH","BELLEVUE, OH",2023-07-07,7,5,-2
1087686772,"BUCYRUS, OH","TYRONE NBER, PA",2023-07-07,0,1,1
1087687508,"FAIR OAKS, VA","AVONDALE, LA",2023-07-07,6,5,-1
3630168999,"COLQUITT, GA","FT SMITH, AR",2023-07-07,8,5,-3
1087537606,"TOLEDO AIRLINE, OH","CHICAGO ENGLEW TV, IL",2023-07-07,8,10,2
3630102082,"ORANGE, TX","BERWICK, PA",2023-07-07,1,3,2
3630062672,"LEIPSIC, OH","LOUISVILLE, KY",2023-07-07,13,10,-3
3630205979,"TOLEDO, OH","CALVERT, AL",2023-07-07,-2,1,3
3630050968,"AUSTELL INTERMODAL, GA","ATLANTA, GA",2023-07-07,4,5,1
1087664152,"NORTH CHARLESTON, SC","NIXON, GA",2023-07-07,8,10,2
1087612888,"MALLARD, AL","DECATUR, AL",2023-07-07,6,4,-2
1087615551,"DARROW, IL","LAFAYETTE, IN",2023-07-07,10,9,-1
3630080507,"HYCO, NC","BAILEY MINE, PA",2023-07-07,1,2,1
3630108884,"ZANESVILLE, OH","WEDRON, IL",2023-07-04,4,7,3
3629137692,"SANDUSKY DOCK, OH","CROOKED CREEK MINE, PA",2023-07-07,2,1,-1
3630090015,"MERIDIAN, MS","JACKSONVILLE, FL",2023-07-07,4,7,3
3630081252,"RUBY, GA","JACKSONVILLE, FL",2023-07-07,4,7,3
1087679775,"HARRISBURG, PA","BARSTOW, CA",2023-07-07,9,8,-1
1087583437,"MASON, OH","ORANGE, TX",2023-07-07,0,2,2
1087613151,"TOLEDO, OH","INDIANA HARBOR, IN",2023-07-07,1,2,1
1087625394,"FT MILL, SC","SAVANNAH, GA",2023-07-07,4,6,2
3630074695,"ST GABRIEL, LA","MOORESVILLE, NC",2023-07-07,4,3,-1
3630132540,"LAMBERTS POINT, VA","WILLIAMSON YARD, WV",2023-07-07,0,1,1
3630217845,"WYLIE, TX","RUTHERFORD, PA",2023-07-07,10,10,0
3630173669,"COSGROVE, MO","NEW ORLEANS, LA",2023-07-07,4,3,-1
1087661861,"SOUTH RALEIGH, NC","WOODLAWN, AL",2023-07-06,5,5,0
3629864621,"LAMBERTS POINT, VA","TOMS CREEK, VA",2023-07-07,4,6,2
3630051859,"LAMBERTS POINT, VA","WILLIAMSON YARD, WV",2023-07-07,5,6,1
3630218817,"MARCUS HOOK, PA","MEDINA, OH",2023-07-07,10,8,-2
3630172249,"HARRISONVILLE, MO","DECATUR, AL",2023-07-07,11,8,-3
3630054695,"CAROL, IN","FRANCISCO, IN",2023-07-07,2,4,2
1087600239,"NEKOOSA, WI","MELVINDALE, MI",2023-07-07,5,4,-1
1087704033,"DUBLIN, GA","OTTAWA LAKE, MI",2023-07-07,7,4,-3
1087621269,"ROSSVILLE, TN","ATLANTA, GA",2023-07-07,-1,1,2
1087604607,"ATHENS, TN","CLAYPOOL, IN",2023-07-07,0,1,1
3630191633,"MONROE, OH","MIDDLETOWN, OH",2023-07-07,7,8,1
3630062494,"LAMBERTS POINT, VA","WILLIAMSON YARD, WV",2023-07-07,2,3,1
1087689178,"CANNELTON (KNWA), WV","LAMBERTS POINT, VA",2023-07-07,2,1,-1
3630173017,"WALDEN, GA","ALLEMANIA, LA",2023-07-07,7,4,-3
1087561859,"RUBY, GA","JACKSONVILLE, FL",2023-07-07,4,7,3
3630157786,"BURNS HARBOR, IN","BURNS HARBOR, IN",2023-07-07,6,7,1
3630197207,"REEDSBURG, WI","SELMA, NC",2023-07-07,3,4,1
1087616769,"BURNS HARBOR, IN","BURNS HARBOR, IN",2023-07-07,-2,1,3
3630190962,"KINGSPORT, TN","PLAQUEMINE, LA",2023-07-07,10,10,0
1087703427,"WYLIE, TX","CROXTON, NJ",2023-07-07,1,3,2
3630080840,"HYCO, NC","BAILEY MINE, PA",2023-07-07,5,2,-3
3630064941,"MONROE, MI","THUNDER JCT WEST, WY",2023-07-07,4,2,-2
1087550109,"LOS ANGELES, CA","CROXTON, NJ",2023-07-07,5,6,1
1087522326,"CAROL, IN","FRANCISCO, IN",2023-07-07,10,10,0
3630064535,"MERIDIAN, MS","CROXTON, NJ",2023-07-07,3,5,2
3630107383,"SANDUSKY DOCK, OH","CROOKED CREEK MINE, PA",2023-07-07,3,5,2
3630114754,"LOS ANGELES, CA","RUTHERFORD, PA",2023-07-03,12,10,-2
3628888800,"WINSTON-SALEM, NC","WHITE PIGEON, MI",2023-07-07,13,10,-3
3630098453,"ASHEVILLE, NC","PINE BLUFF, AR",2023-07-07,6,5,-1
3630182202,"SELKIRK, NY","LAFAYETTE, IN",2023-07-07,7,7,0
3630064420,"MERIDIAN, MS","RUTHERFORD, PA",2023-07-07,3,3,0
1087658216,"GARY, IN","MIDWEST PORTAGE, IN",2023-07-07,-1,1,2
1087666683,"RUEBEL, MN","CHICAGO, IL",2023-07-07,4,6,2
1087714478,"KENOVA, WV","MAULDIN, SC",2023-07-07,4,3,-1
1087658517,"LAFAYETTE, IN","DISCOVERY PARK, OH",2023-07-07,7,6,-1
3630202963,"LAMBERTS POINT, VA","TOMS CREEK, VA",2023-07-07,-1,1,2
1087531155,"BELLEVUE, OH","BELLEVUE, OH",2023-07-07,2,2,0
3630065688,"MONROE, MI","CHICAGO, IL",2023-07-07,4,3,-1
1087687875,"VERTAGREEN, AL","WEBBWOOD, ON",2023-07-07,10,10,0
1087695828,"MIAMI, FL","ATLANTA, GA",2023-07-07,8,7,-1
1087631662,"STAPLETON, GA","BAYPORT, TX",2023-07-07,11,9,-2
3630115661,"MOUNT CARMEL JCT, PA","NORTH VALLIANT, OK",2023-07-07,4,3,-1
3630189149,"LAMBERTS POINT, VA","WILLIAMSON YARD, WV",2023-07-07,5,7,2
3630141468,"ASHEVILLE, NC","BAYTOWN, TX",2023-07-07,3,2,-1
3630104123,"WYLIE, TX","JACKSONVILLE, FL",2023-07-07,7,4,-3
3630204753,"POSTELL, GA","ODUM, GA",2023-07-07,8,9,1
1087606065,"BETHINTERMODAL, PA","ST LOUIS, MO",2023-07-07,3,2,-1
3630079255,"SAN BERNARDINO, CA","JACKSONVILLE, FL",2023-07-07,2,1,-1
3630178669,"PORT ARTHUR, TX","ELIZABETH, NJ",2023-07-07,8,10,2
3630203058,"LAMBERTS POINT, VA","TOMS CREEK, VA",2023-07-07,8,5,-3
3630086676,"LOS ANGELES, CA","CROXTON, NJ",2023-07-07,9,8,-1
3630126662,"DILLEY, TX","PICAYUNE, MS",2023-07-07,5,5,0
3630059467,"LOS ANGELES, CA","RUTHERFORD, PA",2023-07-07,6,7,1
3630144490,"TAMPA, FL","MCINTOSH, AL",2023-07-07,-2,1,3
1087578212,"GATEWAY MINE, IL","WHEATFIELD, IN",2023-07-06,4,7,3
3629999191,"WINSTON-SALEM, NC","WHITE PIGEON, MI",2023-07-07,9,6,-3
3630099506,"THOMASVILLE, PA","BENTONITE, WY",2023-07-07,9,6,-3
3630118782,"YORK, PA","EDGERTON, IN",2023-07-07,9,8,-1
1087660425,"CHICAGO 47TH ST TV, IL","BETHINTERMODAL, PA",2023-07-07,-1,1,2
3630185802,"WYLIE, TX","JACKSONVILLE, FL",2023-07-07,1,1,0
3630134429,"WARREN, PA","ROCHESTER-5, NY",2023-07-07,7,5,-2
1087551105,"BUFFALO, NY","TOLEDO, OH",2023-07-07,3,6,3
3630058152,"LONG BEACH E PIER, CA","COLUMBUS, OH",2023-07-07,4,3,-1
1087694301,"CRAWFORDSVILLE, IN","PRINCETON, IN",2023-07-07,2,2,0
1087591260,"VALDOSTA, GA","BURNSVILLE, MS",2023-07-07,2,2,0
1087608342,"WOODSTOCK, AL","MALLARD, AL",2023-07-07,8,6,-2
3630196162,"DECATUR, AL","WYTHEVILLE, VA",2023-07-07,7,4,-3
3630186701,"ST LUC, PQ","HAVERHILL, OH",2023-07-07,9,7,-2
1087211404,"LAMBERTS POINT, VA","TOMS CREEK, VA",2023-07-07,10,8,-2
3630144555,"EDMONTON INTER TERM, AB","HARRISBURG, PA",2023-07-07,4,1,-3
3630207086,"MARSHALL, MN","DOUGHERTY, GA",2023-07-07,11,10,-1
3630108452,"VALDOSTA, GA","BURNSVILLE, MS",2023-07-07,12,9,-3
3630202955,"LAMBERTS POINT, VA","TOMS CREEK, VA",2023-07-07,4,6,2
3630073500,"CHICAGO 47TH ST TV, IL","CHICAGO 47TH ST TV, IL",2023-07-04,6,3,-3
3629138779,"SANDUSKY DOCK, OH","CROOKED CREEK MINE, PA",2023-07-07,8,5,-3
3630095578,"GATEWAY MINE, IL","WHEATFIELD, IN",2023-07-07,13,10,-3
3630141395,"MAYSVILLE, GA","SIDNEY, OH",2023-07-07,9,10,1
1087634458,"CROXTON, NJ","KANSAS CITY, MO",2023-07-07,6,9,3
3630144644,"HAVEN, WI","HAVERHILL, OH",2023-07-07,4,6,2
3630071621,"LAMBERTS POINT, VA","WILLIAMSON YARD, WV",2023-07-06,7,8,1
1087046370,"LAMBERTS POINT, VA","TOMS CREEK, VA",2023-07-07,3,2,-1
3630101808,"MIDWEST PORTAGE, IN","ROCK ISLAND, IL",2023-07-07,5,3,-2
3630205741,"WARRENTON, OH","SPARTA, WI",2023-07-07,11,10,-1
3630194788,"FARMERS VALLEY, PA","WOODS CROSS, UT",2023-07-07,6,3,-3
1087657105,"NATKA (AIKR), SC","LAKE CHARLES, LA",2023-07-07,6,5,-1
3630189034,"LITTLETON, MA","DECATUR, AL",2023-07-07,3,3,0
1087705372,"YORKTON, SK","DECATUR, IL",2023-07-07,7,6,-1
3630062541,"KANSAS CITY, MO","MELVINDALE, MI",2023-07-07,3,4,1
3630133300,"SELKIRK, NY","BUFFALO, NY",2023-07-07,13,10,-3
3630069145,"ROSSER, GA","BARNESVILLE, GA",2023-07-07,-1,2,3
3630067436,"GEORGETOWN, KY","WESTLAKE, FL",2023-07-07,2,5,3
1087646196,"WICKHAM SPUR, IA","HOPEWELL, VA",2023-07-07,8,6,-2
3630108428,"VALDOSTA, GA","BURNSVILLE, MS",2023-07-07,8,9,1
1087568966,"BOWDEN YARD, FL","VOLTZ MIX CTR, MO",2023-07-07,1,3,2
3630122676,"EAST BRUNSWICK, NJ","HOUSTON, TX",2023-07-07,5,8,3
1087605920,"BETHINTERMODAL, PA","ST LOUIS, MO",2023-07-07,1,4,3
1087558092,"LOS ANGELES, CA","MORRISVILLE, PA",2023-07-07,6,9,3
3630111112,"PARIS, IL","BATTLE CREEK, MI",2023-07-07,5,4,-1
3630139835,"BROWNSON, AL","PICAYUNE, MS",2023-07-07,1,2,1
3630076257,"MERIDIAN, MS","AUSTELL, GA",2023-07-07,6,4,-2
1087596595,"HOLLIDAYSBURG, PA","CLINTON, IA",2023-07-07,4,3,-1
3630141531,"ASHEVILLE, NC","MARYLAND, LA",2023-07-07,8,10,2
1087608059,"HOUSTON, TX","PEDRICKTOWN, NJ",2023-07-07,9,8,-1
3630120640,"MARTINSBURG, WV","LEETSDALE, PA",2023-07-07,5,6,1
3630191340,"BARSTOW, CA","MORRISVILLE, PA",2023-07-07,8,5,-3
1087555298,"CAMPBELL ROAD YARD, OH","VON WILLER (CCRL), OH",2023-07-07,9,6,-3
3630090235,"MEMPHIS JCT, KY","NIXON, GA",2023-07-07,-1,2,3
1087703265,"BRISTOL, VA","TROUTVILLE, VA",2023-07-07,6,6,0
1087714779,"PORTLAND, OR","AUSTELL, GA",2023-07-07,7,9,2
3630199966,"DAYTON, TX","PINEVILLE, NC",2023-07-07,1,3,2
3630213867,"HANNA, OH","BATH, NY",2023-07-07,11,9,-2
3630195433,"PORT HURON, MI","POOLER, GA",2023-07-07,4,6,2
3630057334,"BUFFALO, NY","CHICAGO, IL",2023-07-07,-1,2,3
3630049810,"TROUTVILLE, VA","BRISTOL, VA",2023-07-07,9,6,-3
1087547889,"LAGRANGE, NL","MAUMEE, OH",2023-07-07,4,6,2
3630076752,"LOS ANGELES, CA","KANSAS CITY, MO",2023-07-07,6,6,0
1087630967,"SOUTH RALEIGH, NC","BESSEMER, AL",2023-07-07,2,5,3
1087613224,"TOLEDO, OH","INDIANA HARBOR, IN",2023-07-07,9,8,-1
3630162684,"LOUDON, TN","SOLVAY, WY",2023-07-04,9,6,-3
3629136874,"SANDUSKY DOCK, OH","CROOKED CREEK MINE, PA",2023-07-07,3,6,3
3630072198,"CLEBURNE, TX","CHESAPEAKE, VA",2023-07-07,10,8,-2
1087686057,"MONROE, OH","GARY, IN",2023-07-07,7,10,3
1087675991,"MIDWEST PORTAGE, IN","GARY, IN",2023-07-07,5,2,-3
1087678402,"BUFFALO, NY","BUFFALO, NY",2023-07-06,0,2,2
1087155797,"LAMBERTS POINT, VA","TOMS CREEK, VA",2023-07-07,5,2,-3
3630218859,"OWENSBORO, KY","LEOLA, PA",2023-07-07,3,6,3
1087539098,"RICHMOND, VA","TROUTVILLE, VA",2023-07-07,0,2,2
1087522716,"CAROL, IN","FRANCISCO, IN",2023-07-07,8,5,-3
1087632888,"WANETA, BC","CHATTANOOGA, TN",2023-07-07,10,10,0
3630218168,"AVON, NY","FRANKFORD (DCR), DE",2023-07-07,7,10,3
1087593157,"LOUISVILLE FAIRGR, KY","ROCKPORT, IN",2023-07-07,5,2,-3
1087612498,"DILLEY, TX","PICAYUNE, MS",2023-07-07,8,5,-3
1087526786,"BUTLER, IN","BURNS HARBOR, IN",2023-07-07,11,8,-3
3630213914,"TAYLOR, PA","CHOCOLATE BAYOU, TX",2023-07-07,2,3,1
3630207206,"MARSHALL, MN","ROHRERSTOWN, PA",2023-07-07,4,2,-2
3630205848,"DOUGHERTY, GA","MARSHALL, MN",2023-07-07,-1,2,3
1087708223,"WINSTON-SALEM, NC","HOBBS, IN",2023-07-07,7,6,-1
3630207353,"SOMERSET, KY","OAKDALE, CA",2023-07-07,0,1,1
1087549352,"ATLANTA, GA","CROXTON, NJ",2023-07-07,9,10,1
3630077790,"LOS ANGELES, CA","JACKSONVILLE, FL",2023-07-07,1,1,0
3630138229,"LAMBERTS POINT, VA","WILLIAMSON YARD, WV",2023-07-07,13,10,-3
3630068678,"CHICAGO, IL","COLUMBUS, OH",2023-07-07,6,7,1
3630114047,"WILLIAMSPORT, PA","DANVILLE, IL",2023-07-07,5,3,-2
3630078908,"STOCKTON, CA","HARRISBURG, PA",2023-07-07,6,6,0
3630094271,"KANSAS CITY, MO","MELVINDALE, MI",2023-07-07,6,5,-1
3630197354,"NORTH BIRMINGHAM, AL","SPOCARI, AL",2023-07-07,7,5,-2
1087674791,"BURNS HARBOR, IN","BURNS HARBOR, IN",2023-07-07,7,4,-3
1087599705,"KANSAS CITY, MO","MELVINDALE, MI",2023-07-07,6,7,1
3630057384,"SAN BERNARDINO, CA","HARRISBURG, PA",2023-07-07,5,5,0
3630108787,"CLYMERS, IN","CLYMERS, IN",2023-07-07,6,9,3
1087554925,"MORRISVILLE TV, PA","CHICAGO ENGLEW TV, IL",2023-07-07,3,1,-2
3630151497,"CORNING, NY","GORDON, GA",2023-07-07,1,3,2
3630166298,"DES MOINES, IA","DES MOINES, IA",2023-07-07,2,4,2
3630146905,"MIAMI, FL","CHICAGO 47TH ST TV, IL",2023-07-07,6,5,-1
3630071948,"WYLIE, TX","ATLANTA, GA",2023-07-07,7,7,0
3630115603,"STEELTON, PA","LACASSINE, LA",2023-07-07,4,7,3
1087616719,"BURNS HARBOR, IN","BURNS HARBOR, IN",2023-07-07,8,5,-3
3630074734,"ST GABRIEL, LA","WEST HAZLETON, PA",2023-07-07,11,10,-1
1087528291,"GREENCASTLE, PA","GREENCASTLE, PA",2023-07-07,2,4,2
3630145682,"SIDNEY, MT","MORRISTOWN, TN",2023-07-02,8,9,1
3628756273,"CAROL, IN","FRANCISCO, IN",2023-07-07,5,4,-1
3630155001,"BARNESVILLE, GA","JACKSONVILLE, FL",2023-07-07,5,3,-2
3630071964,"LAMBERTS POINT, VA","WILLIAMSON YARD, WV",2023-07-07,6,4,-2
1087559381,"ROHRERSTOWN, PA","FOSTORIA, OH",2023-07-07,3,4,1
1087614589,"GARLAND, TX","ASHEBORO, NC",2023-07-07,6,7,1
1087520324,"VOLTZ, MO","GCT BAYONNE, NJ",2023-07-07,1,4,3
1087635797,"PITTSBURGH, PA","ELIZABETH MARINE TE, NJ",2023-07-07,4,1,-3
3630115271,"SARNIA, ON","ANDERSON, SC",2023-07-07,5,2,-3
3630217992,"LOS ANGELES, CA","AUSTELL, GA",2023-07-07,4,2,-2
3630193376,"DECATUR, IL","QUINBY, KS",2023-07-07,3,3,0
3630148096,"DECATUR, IL","DECATUR, IL",2023-07-07,12,10,-2
1087564108,"CALVERT CITY, KY","EMORY GAP, TN",2023-07-03,1,4,3
1086105684,"WINSTON-SALEM, NC","WHITE PIGEON, MI",2023-07-07,3,2,-1
3630126272,"MALLARD, AL","DECATUR, AL",2023-07-07,2,2,0
1087590963,"LIMEDALE, IN","FT WAYNE, IN",2023-07-07,8,9,1
3630203032,"LAMBERTS POINT, VA","TOMS CREEK, VA",2023-07-07,4,2,-2
3630140331,"MIAMI, FL","STAR, MS",2023-07-07,0,3,3
3630061804,"KANSAS CITY, MO","KANSAS CITY, MO",2023-07-03,0,1,1
1086389686,"SANDUSKY DOCK, OH","CROOKED CREEK MINE, PA",2023-07-07,6,5,-1
3630193211,"DECATUR, AL","AMES, IA",2023-07-07,0,3,3
3630158114,"BURNS HARBOR, IN","BURNS HARBOR, IN",2023-07-07,9,10,1
1087577795,"GATEWAY MINE, IL","WHEATFIELD, IN",2023-07-07,4,6,2
3630109880,"LOUISVILLE, KY","LOUISVILLE, KY",2023-07-02,10,8,-2
3628755756,"CAROL, IN","FRANCISCO, IN",2023-07-07,5,5,0
3630105072,"BAYTOWN, TX","ROCKAWAY (DD), NJ",2023-07-07,-1,1,2
3630093607,"GARY, IN","MIDWEST PORTAGE, IN",2023-07-07,7,4,-3
3630205652,"CHOCOLATE BAYOU, TX","LINCOLN, AL",2023-07-07,4,5,1
3630080353,"HYCO, NC","BAILEY MINE, PA",2023-07-07,2,5,3
3630146418,"AUGUSTA, MI","DANVILLE, IL",2023-07-07,3,2,-1
3630149377,"CEDAR CITY, UT","CHARLOTTE, NC",2023-07-07,2,2,0
3630049365,"PORT WENTWORTH, GA","ARLINGTON, TX",2023-07-07,4,1,-3
3630155904,"CLAYPOOL, IN","NEW HYDE PARK, NY",2023-07-07,7,5,-2
3630114835,"CLEVELAND, OH","BRISTOL, PA",2023-07-07,7,8,1
3630048741,"CICERO, IL","MORRISVILLE, PA",2023-07-07,4,3,-1
3630171138,"DES MOINES, IA","DES MOINES, IA",2023-07-02,9,8,-1
3628756443,"CAROL, IN","FRANCISCO, IN",2023-07-07,1,3,2
1087657294,"LAMBERTS POINT, VA","WILLIAMSON YARD, WV",2023-07-02,7,8,1
3628671928,"LAMBERTS POINT, VA","TOMS CREEK, VA",2023-07-07,7,5,-2
1087681277,"LATHROP, CA","AUSTELL, GA",2023-07-07,8,8,0
1087547790,"HARRISBURG, PA","CHICAGO, IL",2023-07-07,9,6,-3
3630142765,"MONROE, LA","LEMOYNE, AL",2023-07-07,3,4,1
3630114623,"ORANGE, TX","DAYTON, TN",2023-07-07,6,5,-1
1087708891,"BELLEVUE, OH","SWAINSBORO, GA",2023-07-07,7,6,-1
1087680182,"GEORGETOWN, KY","WESTLAKE, FL",2023-07-07,7,5,-2
1087541257,"HARRISBURG, PA","CHICAGO, IL",2023-07-07,9,10,1
3630084755,"YORK, PA","HOUSTON, TX",2023-07-07,0,2,2
3630216629,"ELKHART, IN","VOLTZ MIX CTR, MO",2023-07-07,8,8,0
3630131358,"MOBERLY, MO","MT VERNON, IL",2023-07-07,10,7,-3
3630212382,"WINSTON-SALEM, NC","HOBBS, IN",2023-07-07,4,4,0
1087711527,"MAUMEE, OH","REYBOLD, DE",2023-07-07,2,5,3
1087640807,"WYLIE, TX","ATLANTA, GA",2023-07-07,6,7,1
3630144822,"SIDNEY, IL","PINEVILLE, NC",2023-07-07,5,6,1
3630210097,"MASON CITY, IA","LACYMARK, FL",2023-07-07,2,2,0
3630052512,"BLUFFTON, IN","SELMA, NC",2023-07-06,10,9,-1
3629883714,"LAMBERTS POINT, VA","TOMS CREEK, VA",2023-07-07,5,4,-1
1087587287,"OLD OCEAN, TX","PINEVILLE, NC",2023-07-07,10,7,-3
3630051956,"BLUFFTON, IN","SELMA, NC",2023-07-02,6,5,-1
3628757059,"CAROL, IN","FRANCISCO, IN",2023-07-07,4,7,3
3630078518,"DET JEFFERSON, MI","ALLIANCE, TX",2023-07-07,6,8,2
1087615933,"DARROW, IL","LAFAYETTE, IN",2023-07-07,5,8,3
1087577193,"GATEWAY MINE, IL","WHEATFIELD, IN",2023-07-07,11,8,-3
3630193229,"SPENCE, ON","LOGANSPORT, IN",2023-07-07,8,9,1
3630151308,"DECATUR, IL","HOMER, IL",2023-07-07,7,6,-1
1087666798,"BUFFALO, NY","STOCKTON, CA",2023-07-07,7,4,-3
3630155108,"WOODSTOCK, ON","WESTLAKE, FL",2023-07-07,1,1,0
3630163143,"TROY GROVE, IL","OAKWOOD, GA",2023-07-07,9,8,-1
1087622215,"ROSSVILLE, TN","RUTHERFORD, PA",2023-07-07,0,2,2
3630148973,"DECATUR, IL","DECATUR, IL",2023-07-07,12,9,-3
3630092211,"WELLSBORO, PA","WYEVILLE, WI",2023-07-07,1,1,0
1087613119,"TOLEDO, OH","INDIANA HARBOR, IN",2023-07-07,4,3,-1
3630105501,"CLEVELAND, OH","BURNS HARBOR, IN",2023-07-07,-1,1,2
3630149000,"LOUISVILLE, KY","VALADECES, TM",2023-07-07,7,6,-1
3630199835,"DAYTON, TX","CHICKAMAUGA, GA",2023-07-07,5,7,2
3630211255,"CHICAGO, IL","CHICAGO, IL",2023-07-07,10,10,0
3630066870,"CINCINNATI, OH","CINCINNATI, OH",2023-07-07,11,10,-1
3630107480,"SANDUSKY DOCK, OH","CROOKED CREEK MINE, PA",2023-07-07,4,6,2
3630105569,"BIGLERVILLE, PA","CHICAGO, IL",2023-07-07,13,10,-3
3630138017,"CLEVELAND WEST PARK, OH","CLEVELAND, OH",2023-07-07,9,10,1
3630178009,"PRINCETON, IN","CRAWFORDSVILLE, IN",2023-07-07,6,5,-1
3630052481,"BLUFFTON, IN","SELMA, NC",2023-07-04,11,9,-2
3629169615,"SANDUSKY DOCK, OH","CROOKED CREEK MINE, PA",2023-07-07,3,3,0
1087613884,"MARTINSBURG, WV","LEETSDALE, PA",2023-07-07,6,5,-1
3630197134,"SANDERSVILLE, GA","WABASH, IN",2023-07-07,10,9,-1
3630134437,"WARREN, PA","ROCHESTER-5, NY",2023-07-07,2,3,1
3630152184,"MITSUE, AB","CHAMBERSBURG, PA",2023-07-07,9,7,-2
3630185072,"FT SMITH, AR","JACKSON, MI",2023-07-07,7,10,3
3630209143,"GYPSUM, OH","POMONA, CA",2023-07-03,5,5,0
1086287868,"LAMBERTS POINT, VA","TOMS CREEK, VA",2023-07-07,4,6,2
3630072287,"BARSTOW, CA","CROXTON, NJ",2023-07-07,2,1,-1
3630183834,"NORFOLK INTERNATION, VA","LANDERS, IL",2023-07-07,4,2,-2
3630199657,"CEDAR RAPIDS, IA","MECHANICSBURG, PA",2023-07-07,11,10,-1
3630186638,"CANTON, OH","WAUPACA, WI",2023-07-07,11,8,-3
1087682087,"MEMPHIS, TN","LAFAYETTE, IN",2023-07-07,-1,1,2
3630072481,"MOORE, CA","YORK, PA",2023-07-07,2,4,2
3630162650,"LACYMARK, FL","JUNCTION CITY, GA",2023-07-07,3,6,3
3630068775,"LOS ANGELES, CA","CROXTON, NJ",2023-07-07,-2,1,3
3630205115,"NORTH BIRMINGHAM, AL","SALTILLO, CU",2023-07-07,3,2,-1
1087633038,"MUNCY (LVRR), PA","CICERO, IL",2023-07-07,8,8,0
1087587960,"LOUDON, TN","LOUDON, TN",2023-07-07,4,2,-2
3630153588,"CLAVET, SK","GAINESVILLE, GA",2023-07-07,9,6,-3
3630095633,"GATEWAY MINE, IL","WHEATFIELD, IN",2023-07-07,3,1,-2
3630175378,"DAYTON, TX","MORRISTOWN, TN",2023-07-07,8,5,-3
3630203749,"LAMBERTS POINT, VA","TOMS CREEK, VA",2023-07-07,12,10,-2
3630105527,"CLEVELAND, OH","BURNS HARBOR, IN",2023-07-07,3,2,-1
3630138847,"SERGEANT BLUFF, IA","SCHOOLCRAFT, MI",2023-07-07,11,9,-2
1087546867,"CHICAGO, IL","COLUMBUS, OH",2023-07-07,2,5,3
1087650014,"FARRELL, PA","PAULSBORO, NJ",2023-07-07,9,10,1
3630066553,"MODESTO, CA","SCRANTON, PA",2023-07-07,10,7,-3
3630142016,"PETERSBURG, VA","FAIRBANK, IA",2023-07-07,7,4,-3
3630177281,"MEMPHIS, TN","BROWNSTOWN, MI",2023-07-07,6,8,2
3630168591,"OAKWOOD, MI","GARY, IN",2023-07-07,9,10,1
3630137736,"LOUISVILLE, KY","APPLIANCE PARK, KY",2023-07-07,2,1,-1
3630085939,"BOWDEN YARD, FL","CHICAGO 47TH ST TV, IL",2023-07-07,1,2,1
1087561558,"HYCO, NC","BAILEY MINE, PA",2023-07-07,4,6,2
3630158716,"BURNS HARBOR, IN","BURNS HARBOR, IN",2023-07-07,7,4,-3
3630173554,"WILMINGTON, CA","PORT NEWARK ELIZABE, NJ",2023-07-07,6,4,-2
1087710864,"NEW ORLEANS, LA","NEW ORLEANS, LA",2023-07-07,4,4,0
3630205856,"DOUGHERTY, GA","MARSHALL, MN",2023-07-07,5,7,2
3630094001,"MEMPHIS, TN","JACKSONVILLE, FL",2023-07-07,13,10,-3
3630153253,"HUNTSVILLE, AL","ATHENS, AL",2023-07-07,1,3,2
3630092740,"RINCON, GA","BROOKLAWN, LA",2023-07-07,10,9,-1
3630073194,"KANSAS CITY, MO","WANETA, BC",2023-07-07,4,3,-1
3630210592,"CHICAGO, IL","CHICAGO MIX CTR, IL",2023-07-07,2,5,3
1087529271,"MAHRT (CCH), AL","PORT WENTWORTH, GA",2023-07-07,10,8,-2
3630111552,"CLEVELAND, OH","MIDWEST PORTAGE, IN",2023-07-07,0,2,2
3630152419,"LOS ANGELES, CA","AUSTELL, GA",2023-07-07,10,9,-1
3630096061,"FOUNTAIN, AL","MCINTOSH, AL",2023-07-07,3,2,-1
3630200042,"CLYMERS, IN","HANNA, OH",2023-07-07,4,7,3
3630070112,"WYLIE, TX","ATLANTA, GA",2023-07-07,7,10,3
1087679212,"PRINCETON, IN","PINE, IN",2023-07-07,5,5,0
3630170695,"SENATOBIA, MS","SYLACAUGA, AL",2023-07-07,1,3,2
1087594098,"EL DORADO, AR","HARRISBURG, NC",2023-07-07,10,8,-2
3630179958,"DEMOPOLIS, AL","HILL, AL",2023-07-07,2,3,1
3630063589,"PAULA, HG","WEST OCCIDENTAL, FL",2023-07-07,10,7,-3
3630080450,"HYCO, NC","BAILEY MINE, PA",2023-07-07,7,10,3
3630074310,"DALLAS, TX","HARRISBURG, PA",2023-07-07,3,1,-2
1087527944,"GREENCASTLE, PA","GREENCASTLE, PA",2023-07-07,4,4,0
1087540146,"DECATUR, IL","CAREY, OH",2023-07-07,11,9,-2
3630132825,"SELKIRK, NY","BUFFALO, NY",2023-07-07,6,7,1
3630107121,"SANDUSKY DOCK, OH","CROOKED CREEK MINE, PA",2023-07-07,1,1,0
3630064640,"MERIDIAN, MS","AUSTELL INTERMODAL, GA",2023-07-07,3,3,0
1087686390,"RUTHERFORD, PA","JACKSONVILLE, FL",2023-07-07,8,8,0
3630127626,"TOLEDO, OH","INDIANA HARBOR, IN",2023-07-07,6,3,-3
1087599543,"STEELTON, PA","LACASSINE, LA",2023-07-07,13,10,-3
1087544823,"LEMOYNE, AL","REIDSVILLE, NC",2023-07-07,1,1,0
3630208464,"BRANDON, MB","OCCIDENTAL, FL",2023-07-07,5,4,-1
3630152524,"NORTH VALLIANT, OK","EATON, OH",2023-07-07,3,2,-1
3630179851,"HILL, AL","EVADALE, TX",2023-07-07,2,4,2
3630116772,"BOND HILL, OH","BIG ISLAND, WY",2023-07-07,6,3,-3
1087592177,"LEMOYNE, AL","MOBILE, AL",2023-07-07,5,2,-3
3630049593,"TROUTVILLE, VA","WINSTON-SALEM, NC",2023-07-07,5,4,-1
3630065230,"BIRMINGHAM, MO","DETROIT DEARBORN, MI",2023-07-07,-1,2,3
3630062177,"BELLEVUE, OH","BELLEVUE, OH",2023-07-07,8,9,1
3630145747,"CITY OF INDUSTRY, CA","PITTSBURGH, PA",2023-07-07,11,8,-3
1087535183,"KANSAS CITY, MO","KANSAS CITY, MO",2023-07-07,4,5,1
3630069268,"TACOMA BLAIR, WA","CLEVELAND, OH",2023-07-07,11,10,-1
3630205458,"KANSAS CITY, MO","MELVINDALE, MI",2023-07-07,2,4,2
3630108347,"VALDOSTA, GA","BURNSVILLE, MS",2023-07-07,5,2,-3
3630217803,"LOS ANGELES, CA","CHARLOTTE, NC",2023-07-07,2,2,0
3630048482,"CICERO, IL","COLUMBUS, OH",2023-07-07,5,5,0
1087580803,"NORFOLK, VA","NORFOLK, VA",2023-07-07,12,10,-2
3630137998,"SAGINAW, TX","GIBSON CITY, IL",2023-07-07,7,10,3
3630125462,"BURNS HARBOR, IN","BURNS HARBOR, IN",2023-07-07,11,9,-2
1087598555,"CLEVELAND, OH","WAYNE, MI",2023-07-07,7,6,-1
1087711438,"BRACKENRIDGE, PA","BRISTOL, PA",2023-07-07,4,4,0
3630121963,"ATLANTA, GA","SANDERSVILLE, GA",2023-07-07,6,6,0
3630056702,"LAMBERTS POINT, VA","WILLIAMSON YARD, WV",2023-07-07,3,4,1
1087652155,"WITT, TN","KRANNERT, GA",2023-07-07,8,8,0
1087594022,"SARNIA, ON","WASHINGTON (DD), NJ",2023-07-07,8,7,-1
3630188567,"LAFAYETTE, IN","CLYMERS, IN",2023-07-07,6,9,3
3630152396,"PORTLAND, OR","CHARLOTTE, NC",2023-07-07,10,10,0
3630109898,"LOUISVILLE, KY","LOUISVILLE, KY",2023-07-07,1,1,0
3630142008,"LAMBERTS POINT, VA","WILLIAMSON YARD, WV",2023-07-07,0,3,3
1087621667,"CHALCO, NE","BURNS HARBOR, IN",2023-07-07,4,7,3
3630117045,"WYLIE, TX","RUTHERFORD, PA",2023-07-07,3,6,3
1087636688,"CHICAGO HEIGHTS, IL","BIRMINGHAM, MO",2023-07-02,8,8,0
3628755968,"CAROL, IN","FRANCISCO, IN",2023-07-07,7,5,-2
3630191219,"BAYONNE, NJ","PAULSBORO, NJ",2023-07-07,7,9,2
1087694903,"AUSTELL, GA","KANSAS CITY, MO",2023-07-07,7,8,1
1087706116,"LOS ANGELES, CA","CHARLOTTE, NC",2023-07-07,0,2,2
3630068660,"CHICAGO, IL","COLUMBUS, OH",2023-07-07,9,7,-2
3630175417,"DAYTON, TX","CHICKAMAUGA, GA",2023-07-07,7,5,-2
3630218702,"BAINBRIDGE, GA","SANDERSVILLE, MS",2023-07-07,1,2,1
3630134665,"LAMBERTS POINT, VA","WILLIAMSON YARD, WV",2023-07-07,9,8,-1
1087522952,"CAROL, IN","FRANCISCO, IN",2023-07-07,4,3,-1
3630206349,"MELVINDALE, MI","KANSAS CITY, MO",2023-07-07,7,4,-3
3630114186,"LOS ANGELES, CA","CROXTON, NJ",2023-07-07,2,5,3
3630051095,"DETROIT NORTH YD, MI","MACK YARD, MI",2023-07-07,12,10,-2
3630131324,"KANKAKEE, IL","DALTON, GA",2023-07-07,5,6,1
3630110271,"NORFOLK, NE","PORTAGE, IN",2023-07-07,5,4,-1
3630070722,"LOS ANGELES, CA","CROXTON, NJ",2023-07-07,4,5,1
1087614783,"PAULSBORO, NJ","TUCKAHOE, NJ",2023-07-07,9,10,1
1087705233,"GEORGETOWN, KY","WA UNITED TRM (WUT), WA",2023-07-07,7,9,2
3630089991,"MERIDIAN, MS","JACKSONVILLE, FL",2023-07-07,5,3,-2
3630089501,"GREENVILLE, SC","DAYTON, TX",2023-07-07,12,10,-2
3630154306,"PT EVERGLADES, FL","BLAIR, NE",2023-07-07,9,8,-1
1087621748,"GROVESTONE, NC","DRUMMOND, IL",2023-07-07,8,10,2
1087649762,"SOUTH TEXARKANA, TX","HAZLETON, PA",2023-07-07,5,2,-3
1087616874,"MIDWEST PORTAGE, IN","MIDWEST PORTAGE, IN",2023-07-07,6,5,-1
3630203139,"LAMBERTS POINT, VA","TOMS CREEK, VA",2023-07-02,3,5,2
3628757237,"CAROL, IN","FRANCISCO, IN",2023-07-07,7,6,-1
3630129911,"DARROW, IL","LAFAYETTE, IN",2023-07-07,4,5,1
3630105365,"CHOCOLATE BAYOU, TX","CORNELIA, GA",2023-07-07,5,6,1
1087708053,"WARREN, GA","PORT WENTWORTH, GA",2023-07-07,3,4,1
3630177231,"JACKSON, MI","CALVERT CITY, KY",2023-07-07,4,6,2
3630185844,"WILLIAMSPORT, MD","WESTVACO, WY",2023-07-07,6,5,-1
3630145755,"RIVER TERMINAL, NC","TEXAS CITY, TX",2023-07-07,6,4,-2
3630204070,"GREAT FALLS, MT","FREMONT, IN",2023-07-04,4,3,-1
3629138753,"SANDUSKY DOCK, OH","CROOKED CREEK MINE, PA",2023-07-07,1,1,0
1087619783,"SELKIRK, NY","BUFFALO, NY",2023-07-07,3,5,2
3630175213,"LATHROP, CA","CHARLOTTE, NC",2023-07-07,7,9,2
3630218142,"CASKEY, SC","TOLEDO, OH",2023-07-07,11,9,-2
3630128428,"MALLARD, AL","DECATUR, AL",2023-07-07,2,3,1
3630192867,"VERTAGREEN, AL","KIRKLAND LAKE, ON",2023-07-07,10,8,-2
3630118669,"CRESSON, PA","CLEVELAND, OH",2023-07-07,6,9,3
1087679995,"MERIDIAN, MS","MERIDIAN, MS",2023-07-07,11,9,-2
3630059205,"LONG BEACH E PIER, CA","COLUMBUS, OH",2023-07-02,7,5,-2
3628723115,"LAMBERTS POINT, VA","TOMS CREEK, VA",2023-07-07,4,7,3
1087621188,"ROSSVILLE, TN","CHARLESTON, SC",2023-07-07,9,8,-1
3630093851,"MEMPHIS, TN","CHARLOTTE, NC",2023-07-07,11,8,-3
3630208749,"MEMPHIS, TN","MEMPHIS, TN",2023-07-07,5,8,3
3630072512,"COORS CROSSING, VA","EDDYVILLE, IA",2023-07-07,9,6,-3
3630171390,"YOUNGSTOWN, OH","NORTH BERGEN, NJ",2023-07-07,6,8,2
1087561582,"HYCO, NC","BAILEY MINE, PA",2023-07-07,4,6,2
3630145438,"PLAQUEMINE, LA","PRUETT, AL",2023-07-07,2,4,2
3630060816,"CHICAGO, IL","CINCINNATI, OH",2023-07-07,3,6,3
3630112215,"PINEVILLE, NC","CHICAGO, IL",2023-07-07,1,4,3
3630078225,"CLEVELAND, OH","VON WILLER (CCRL), OH",2023-07-07,5,8,3
3630136772,"MEADVILLE, PA","HAYTI, MO",2023-07-02,10,8,-2
3628671130,"CHARLOTTE, NC","WHITE PIGEON, MI",2023-07-07,4,6,2
3630189385,"ELKHART, IN","LIMEDALE, IN",2023-07-07,4,7,3
3630172079,"ADDIS, LA","SOUTH ANDERSON, SC",2023-07-07,1,1,0
3630118863,"FARMERS VALLEY, PA","HOUSTON, TX",2023-07-07,7,9,2
1087711519,"MAUMEE, OH","REYBOLD, DE",2023-07-07,11,8,-3
3630076215,"MERIDIAN, MS","AUSTELL, GA",2023-07-07,-2,1,3
3630087020,"KANSAS CITY, MO","MELVINDALE, MI",2023-07-07,6,7,1
3630086032,"ST LOUIS, MO","CAMP HILL, PA",2023-07-07,11,8,-3
3630203804,"GRIFFITH, NC","SAVANNAH, GA",2023-07-07,6,6,0
3630059166,"LONG BEACH E PIER, CA","CLEVELAND, OH",2023-07-07,11,10,-1
3630138481,"APPLIANCE PARK, KY","APPLIANCE PARK, KY",2023-07-07,7,6,-1
3630071142,"GREER, SC","CHARLESTON, SC",2023-07-07,2,1,-1
1087613339,"TOLEDO, OH","INDIANA HARBOR, IN",2023-07-07,12,10,-2
3630212926,"EVADALE, TX","LOFTON, VA",2023-07-07,-1,1,2
1087585413,"ARBELA, MS","KERNERSVILLE, NC",2023-07-04,11,9,-2
3629169665,"SANDUSKY DOCK, OH","CROOKED CREEK MINE, PA",2023-07-07,3,5,2
3630189733,"COLUMBIA CITY, IN","ST LOUIS, MO",2023-07-07,8,7,-1
3630218265,"CARROLLTON, GA","BIRMINGHAM, AL",2023-07-07,2,1,-1
1087546362,"MEMPHIS, TN","MEMPHIS, TN",2023-07-07,3,5,2
3630086977,"KANSAS CITY, MO","MELVINDALE, MI",2023-07-07,4,1,-3
3630109686,"LOUISVILLE, KY","LOUISVILLE, KY",2023-07-02,8,8,0
3628756003,"CAROL, IN","FRANCISCO, IN",2023-07-07,8,9,1
3630189644,"COLUMBIA CITY, IN","ST LOUIS, MO",2023-07-07,5,8,3
1087690640,"LOUISVILLE FAIRGR, KY","DEER PARK, TX",2023-07-07,-2,1,3
3630076095,"MERIDIAN, MS","JACKSONVILLE, FL",2023-07-07,9,9,0
3630116235,"NEKOOSA, WI","MELVINDALE, MI",2023-07-07,6,6,0
3630060125,"KANSAS CITY, MO","KANSAS CITY, MO",2023-07-07,2,2,0
1087593123,"CULPEPER, VA","SUMMERVILLE, SC",2023-07-07,4,1,-3
3630218215,"DALLAS, TX","CROXTON, NJ",2023-07-07,7,4,-3
3630072889,"LOGISTICS PARK KANS, KS","HARRISBURG, PA",2023-07-07,7,5,-2
3630049763,"TROUTVILLE, VA","WINSTON-SALEM, NC",2023-07-07,4,1,-3
3630052237,"BLUFFTON, IN","SELMA, NC",2023-07-03,8,7,-1
3629053589,"LAMBERTS POINT, VA","TOMS CREEK, VA",2023-07-07,-2,1,3
1087521477,"CAROL, IN","FRANCISCO, IN",2023-07-07,12,10,-2
1087667338,"DALLAS, TX","CROXTON, NJ",2023-07-07,8,7,-1
1087703493,"DES MOINES, IA","DES MOINES, IA",2023-07-07,12,9,-3
3630077685,"ROANOKE, VA","PORT WILMINGTON, DE",2023-07-07,10,9,-1
3630056265,"MERIDIAN, MS","AUSTELL, GA",2023-07-07,2,2,0
3630190140,"MT CARMEL, VA","BAYPORT, TX",2023-07-07,3,1,-2
3630079310,"PERRY, AR","FREMONT, OH",2023-07-07,2,1,-1
3630107692,"SANDUSKY DOCK, OH","CROOKED CREEK MINE, PA",2023-07-07,6,7,1
3630163436,"CALGARY, AB","CHICAGO, IL",2023-07-07,5,2,-3
3630211158,"WINSTON-SALEM, NC","HOBBS, IN",2023-07-07,5,4,-1
1087596383,"COLUMBUS, OH","TACOMA, WA",2023-07-07,7,6,-1
1087607540,"TALLADEGA, AL","CALVERT, AL",2023-07-07,6,6,0
3630197906,"ROANOKE, IN","WENTZVILLE, MO",2023-07-07,7,9,2
3630088018,"BOWDEN YARD, FL","POSTELL, GA",2023-07-07,2,1,-1
3630155514,"WICKHAM SPUR, IA","HOPEWELL, VA",2023-07-07,5,6,1
3630081838,"BUTLER, IN","CONCORD, ON",2023-07-07,1,1,0
3630137613,"RICHARDTON, ND","LANDISVILLE, PA",2023-07-07,4,6,2
3630099132,"ROSEPORT, MN","HOPEWELL, VA",2023-07-07,6,9,3
3630104092,"BERKELEY, MO","GREEN BAY, WI",2023-07-07,2,4,2
1087638787,"WYLIE, TX","JACKSONVILLE, FL",2023-07-07,5,8,3
3630080222,"HYCO, NC","BAILEY MINE, PA",2023-07-07,3,2,-1
3630156489,"GREER, SC","CHARLESTON, SC",2023-07-07,10,10,0
3630211742,"ACKLEY, IA","DORAVILLE, GA",2023-07-07,7,4,-3
3630151976,"KEOKUK, IA","ALTOONA, PA",2023-07-07,1,4,3
1087567928,"KANSAS CITY, MO","MELVINDALE, MI",2023-07-07,2,2,0
1087598783,"ALBANY, NY","SAN BERNARDINO, CA",2023-07-07,5,7,2
3630186557,"ORLANDO, FL","DECATUR, IL",2023-07-07,5,5,0
3630199542,"COSHOCTON, OH","BRIDGEPORT (SLRS), NJ",2023-07-07,8,9,1
1087678135,"CORUNNA, ON","NEAL, WV",2023-07-07,-1,1,2
3630188494,"LAFAYETTE, IN","CLYMERS, IN",2023-07-07,4,2,-2
3630187333,"MEMPHIS PRES, TN","MEMPHIS, TN",2023-07-07,0,2,2
1087530921,"BELLEVUE, OH","BELLEVUE, OH",2023-07-07,2,4,2
3630111879,"WILLIAMSPORT, PA","WEDRON, IL",2023-07-07,0,3,3
3630137663,"LAMBERTS POINT, VA","WILLIAMSON YARD, WV",2023-07-06,9,7,-2
1087308235,"LAMBERTS POINT, VA","TOMS CREEK, VA",2023-07-07,6,7,1
3630056087,"MERIDIAN, MS","CHARLOTTE, NC",2023-07-07,5,4,-1
3630182668,"SANDERSVILLE, GA","WINDSOR, ON",2023-07-07,8,8,0
1087657888,"BRILLS, NJ","NEW LEXINGTON (OSRR, OH",2023-07-07,8,8,0
3630125072,"BURNS HARBOR, IN","BURNS HARBOR, IN",2023-07-07,2,4,2
1087593961,"PARIS, IL","BATTLE CREEK, MI",2023-07-07,3,4,1
3630133287,"SELKIRK, NY","BUFFALO, NY",2023-07-07,4,5,1
3630206886,"DECATUR, IL","OPTIMA, OK",2023-07-07,10,7,-3
1087555311,"CAMPBELL ROAD YARD, OH","VON WILLER (CCRL), OH",2023-07-07,-2,1,3
3630055057,"BUTLER, IN","NORTH BANGOR, ME",2023-07-07,-1,2,3
3630122854,"MERIDIAN, MS","JACKSONVILLE, FL",2023-07-07,6,3,-3
3630189806,"PUERTA MEXICO, EM","JACKSONVILLE, FL",2023-07-07,4,7,3
3630187650,"CHICAGO, IL","CHICAGO MIX CTR, IL",2023-07-07,-1,2,3
3630194657,"SANDERSVILLE, GA","WEST MONROE, LA",2023-07-07,3,6,3
3630134487,"HARRISBURG, PA","HARRISBURG, PA",2023-07-07,9,7,-2
3630067915,"LAFAYETTE, IN","LAFAYETTE, IN",2023-07-07,8,10,2
1087518076,"PITCAIRN, PA","ELIZABETH MARINE TE, NJ",2023-07-07,7,7,0
3630206365,"WYLIE, TX","CROXTON, NJ",2023-07-07,0,1,1
3630172427,"BEAVERDAM, OH","CHALMETTE, LA",2023-07-07,5,2,-3
3630133041,"SELKIRK, NY","BUFFALO, NY",2023-07-07,3,3,0
3630171625,"KANSAS CITY, MO","MELVINDALE, MI",2023-07-07,8,9,1
3630064098,"LOS ANGELES, CA","CROXTON, NJ",2023-07-07,0,2,2
1087644762,"PT EVERGLADES, FL","BLAIR, NE",2023-07-07,6,3,-3
3630203642,"LAMBERTS POINT, VA","TOMS CREEK, VA",2023-07-07,4,1,-3
1087542300,"GEORGETOWN, KY","MIRA LOMA, CA",2023-07-07,5,2,-3
3630099158,"CITY OF INDUSTRY, CA","GREENSBORO, NC",2023-07-07,1,3,2
1087627435,"DECATUR, IL","HAPEVILLE, GA",2023-07-07,6,5,-1
3630188096,"PORT WILMINGTON, DE","WESTVACO, WY",2023-07-07,5,2,-3
3630193570,"ST GABRIEL, LA","HUNTERSVILLE, NC",2023-07-07,1,2,1
3630096100,"PUTNAM, CT","PRATTVILLE, AL",2023-07-07,8,6,-2
1087669916,"JACKSON, MI","CALVERT CITY, KY",2023-07-07,3,6,3
1087677799,"BUFFALO, NY","CHICAGO, IL",2023-07-07,10,7,-3
3630136594,"GRANITE CITY, IL","HOPEWELL, VA",2023-07-07,11,9,-2
3630138067,"PITTSFIELD, MA","KANKAKEE, IL",2023-07-07,7,9,2
3630152401,"LATHROP, CA","HARRISBURG, PA",2023-07-07,4,6,2
3630081993,"CALVERT, AL","INDIANA HARBOR, IN",2023-07-07,2,1,-1
3630164848,"TENNILLE, GA","HARTFORD, IL",2023-07-07,9,9,0
1087518686,"CHICAGO, IL","HARRISBURG, PA",2023-07-07,4,5,1
1087714800,"TULARE, CA","COLUMBUS, OH",2023-07-07,11,10,-1
1087623847,"CHICAGO, IL","CHICAGO MIX CTR, IL",2023-07-03,8,10,2
3628888606,"WINSTON-SALEM, NC","WHITE PIGEON, MI",2023-07-07,3,3,0
1087661170,"EDDYVILLE, IA","COORS CROSSING, VA",2023-07-07,10,7,-3
3630056671,"SHULER, SC","ETOWAH, TN",2023-07-07,3,2,-1
3630203244,"LAMBERTS POINT, VA","TOMS CREEK, VA",2023-07-07,4,3,-1
3630061113,"CHICAGO, IL","GEORGETOWN, KY",2023-07-07,11,10,-1
3630069161,"TACOMA BLAIR, WA","COLUMBUS, OH",2023-07-07,1,3,2
1087701035,"VOLTZ, MO","NORFOLK INTERNATION, VA",2023-07-07,12,9,-3
3630095170,"GATEWAY MINE, IL","WHEATFIELD, IN",2023-07-07,3,4,1
3630065921,"CHICAGO, IL","CHICAGO, IL",2023-07-07,7,7,0
1087619644,"SELKIRK, NY","BUFFALO, NY",2023-07-07,11,10,-1
3630057685,"LONG BEACH E PIER, CA","CLEVELAND, OH",2023-07-07,1,3,2
1087689453,"CANNELTON (KNWA), WV","LAMBERTS POINT, VA",2023-07-07,5,6,1
3630095918,"BATH, PA","FEDERAL, IL",2023-07-07,8,6,-2
1087665700,"WILMINGTON, CA","PORT NEWARK ELIZABE, NJ",2023-07-02,2,2,0
3628723589,"LAMBERTS POINT, VA","TOMS CREEK, VA",2023-07-07,3,2,-1
3630107545,"SANDUSKY DOCK, OH","CROOKED CREEK MINE, PA",2023-07-02,-1,1,2
3628756299,"CAROL, IN","FRANCISCO, IN",2023-07-07,9,10,1
3630125658,"GASTONIA, NC","ROBERTA, AL",2023-07-07,8,8,0
3630138431,"CINCINNATI, OH","SHARONVILLE, OH",2023-07-07,4,6,2
3630113855,"BRANTFORD, ON","FUQUAY-VARINA, NC",2023-07-07,8,5,-3
3630079970,"FLORENCE, SC","FT PAYNE, AL",2023-07-07,4,3,-1
1087577389,"GATEWAY MINE, IL","WHEATFIELD, IN",2023-07-07,1,3,2
1087655763,"STERLING HEIGHTS, MI","ROLLA, CO",2023-07-07,-1,1,2
3630126468,"DILLEY, TX","PICAYUNE, MS",2023-07-07,1,3,2
1087650226,"DALLAS, TX","NORFOLK, VA",2023-07-07,5,8,3
1087612367,"DILLEY, TX","PICAYUNE, MS",2023-07-07,11,9,-2
3630131837,"WEIRTON, WV","BURNS HARBOR, IN",2023-07-07,2,3,1
1087672147,"FOSTORIA, OH","DOWNS, KS",2023-07-07,9,8,-1
1087616256,"BURNS HARBOR, IN","BURNS HARBOR, IN",2023-07-07,9,9,0
1087686235,"BAYONNE, NJ","PAULSBORO, NJ",2023-07-07,3,3,0
3630169652,"EDDYVILLE, IA","COORS CROSSING, VA",2023-07-07,4,2,-2
3630129335,"LOCK JOINT, SC","ALIQUIPPA, PA",2023-07-07,6,7,1
1087566930,"ST LOUIS, MO","CAMP HILL, PA",2023-07-07,6,3,-3
3630154453,"BENTONITE, WY","YORK, PA",2023-07-07,11,8,-3
1087667558,"TIPTON, IN","CHARLESTON BOTTOMS, KY",2023-07-07,5,3,-2
3630068335,"CHICAGO, IL","CROXTON, NJ",2023-07-07,6,3,-3
3630076956,"CICERO, IL","MORRISVILLE, PA",2023-07-07,6,7,1
3630170742,"MUNCY (LVRR), PA","LORDSTOWN, OH",2023-07-07,11,8,-3
3630092928,"WAYNESBURG, PA","BETHLEHEM, PA",2023-07-07,2,1,-1
3630191031,"BAYONNE, NJ","BRAITHWAITE, LA",2023-07-07,5,3,-2
3630085052,"LOS ANGELES, CA","JACKSONVILLE, FL",2023-07-07,10,10,0
3630128826,"BURNS HARBOR, IN","BURNS HARBOR, IN",2023-07-07,11,8,-3
1087603384,"CRESSON, PA","CLEVELAND, OH",2023-07-06,8,5,-3
1087046168,"LAMBERTS POINT, VA","TOMS CREEK, VA",2023-07-07,2,4,2
3630203210,"LAMBERTS POINT, VA","TOMS CREEK, VA",2023-07-07,5,8,3
3630154932,"TOLEDO, OH","LAUREL, MT",2023-07-07,3,1,-2
3630176992,"FAIRFAX, KS","WALKERTOWN, NC",2023-07-07,6,3,-3
1087536040,"CHICAGO, IL","AUSTELL, GA",2023-07-07,3,5,2
3630097669,"TAYLOR, PA","SCHENECTADY, NY",2023-07-07,10,7,-3
1087527839,"ATLANTA, GA","RUTHERFORD, PA",2023-07-07,7,4,-3
3630059962,"REYBOLD, DE","YULEE, FL",2023-07-07,2,5,3
1087579739,"SAVANNAH, GA","MADISON, AL",2023-07-07,8,10,2
3630211069,"FREMONT, OH","LATHROP, CA",2023-07-07,8,7,-1
3630061074,"CHICAGO, IL","APPLIANCE PARK, KY",2023-07-07,6,7,1
1087646578,"ICTF, CA","GEORGETOWN, KY",2023-07-07,9,6,-3
1087650357,"FARRELL, PA","PAULSBORO, NJ",2023-07-07,9,9,0
3630146735,"ARMOREL, AR","BATH, PA",2023-07-07,5,6,1
1087615137,"GREER, SC","CHARLESTON, SC",2023-07-07,0,2,2
3630060793,"CHICAGO, IL","CINCINNATI, OH",2023-07-07,5,3,-2
1087692838,"TITUSVILLE, FL","SAN BERNARDINO, CA",2023-07-07,3,6,3
3630107969,"DALTON, GA","BATON ROUGE, LA",2023-07-07,8,6,-2
3630063490,"LOS ANGELES, CA","CROXTON, NJ",2023-07-07,1,2,1
3630186793,"TACOMA EXPORT, WA","COLUMBUS, OH",2023-07-07,1,1,0
3630059344,"WYSOX, PA","WEDRON, IL",2023-07-07,0,1,1
1087517884,"PORT WENTWORTH, GA","STUARTS DRAFT, VA",2023-07-07,4,1,-3
3630070162,"SAN BERNARDINO, CA","CHARLOTTE, NC",2023-07-07,2,5,3
3630155564,"WICKHAM SPUR, IA","HOPEWELL, VA",2023-07-07,6,4,-2
3630113562,"SAYRE, PA","WOODS CROSS, UT",2023-07-07,5,8,3
1087686154,"FRONT ROYAL, VA","NORFOLK INTERNATION, VA",2023-07-07,10,8,-2
3630185014,"JONESBORO, AR","BATTLE CREEK, MI",2023-07-07,-1,1,2
3630142715,"WYLIE, TX","RUTHERFORD, PA",2023-07-07,1,3,2
3630064828,"MONROE, MI","THUNDER JCT WEST, WY",2023-07-07,-2,1,3
1087535133,"PITCAIRN, PA","CHICAGO ENGLEW TV, IL",2023-07-07,8,7,-1
1087574357,"WAYNESBURG, PA","BETHLEHEM, PA",2023-07-07,-1,2,3
3630127870,"BURNS HARBOR, IN","BURNS HARBOR, IN",2023-07-07,4,6,2
3630134615,"CHICAGO, IL","ELKHART, IN",2023-07-07,9,7,-2
1087543322,"CHICAGO, IL","COLUMBUS, OH",2023-07-07,6,9,3
3630107430,"SANDUSKY DOCK, OH","CROOKED CREEK MINE, PA",2023-07-07,1,4,3
3630097986,"WYLIE, TX","CHARLOTTE, NC",2023-07-02,11,8,-3
3628755675,"CAROL, IN","FRANCISCO, IN",2023-07-07,7,10,3
1087533644,"MODESTO, CA","SCRANTON, PA",2023-07-07,1,2,1
1087539470,"MONROE, MI","CHICAGO, IL",2023-07-07,11,8,-3
1087609958,"CONSTANTINE, MI","FORMOSA, TX",2023-07-07,8,6,-2
1087689136,"CANNELTON (KNWA), WV","LAMBERTS POINT, VA",2023-07-07,5,7,2
3630203529,"LAMBERTS POINT, VA","TOMS CREEK, VA",2023-07-07,6,6,0
3630166361,"DES MOINES, IA","DES MOINES, IA",2023-07-07,-1,1,2
3630068555,"CHICAGO, IL","COLUMBUS, OH",2023-07-07,9,9,0
1087546451,"CITY OF INDUSTRY, CA","GREENSBORO, NC",2023-07-07,5,8,3
1087599268,"MT OLIVE, IL","BOISE SOUTHERN, LA",2023-07-07,5,7,2
1087582180,"LOS ANGELES, CA","CROXTON, NJ",2023-07-07,3,6,3
3630205880,"DOUGHERTY, GA","MARSHALL, MN",2023-07-07,8,10,2
3630167668,"BURNS HARBOR, IN","DECATUR, AL",2023-07-07,-1,2,3
3630195271,"BELLEVUE, OH","CALVERT, AL",2023-07-07,8,6,-2
3630109513,"RED DEER, AB","BLYTHEWOOD, SC",2023-07-07,5,3,-2
3630167935,"RADFORD, NC","GREEN BAY, WI",2023-07-02,7,5,-2
3628756231,"CAROL, IN","FRANCISCO, IN",2023-07-07,7,7,0
1087654173,"MERIDIAN, MS","JACKSONVILLE, FL",2023-07-07,3,1,-2
3630207222,"YORKTON, SK","VALDOSTA, GA",2023-07-07,11,10,-1
3630116748,"SELMA, NC","DECATUR, IL",2023-07-07,2,4,2
3630111057,"SARNIA, ON","WASHINGTON (DD), NJ",2023-07-07,13,10,-3
3630160056,"RINGGOLD, VA","JAMAICA, NY",2023-07-07,8,5,-3
3630050934,"DECATUR, IL","DECATUR, IL",2023-07-07,1,1,0
1087702489,"MARSHALL, MN","DOUGHERTY, GA",2023-07-07,6,5,-1
3630207971,"FRANKFORT, IN","DECATUR, IL",2023-07-07,5,7,2
3630211920,"WINSTON-SALEM, NC","HOBBS, IN",2023-07-07,12,9,-3
1087588673,"BAYTOWN, TX","NORCROSS, GA",2023-07-07,2,1,-1
1087606756,"INSTITUTE (KNWA), WV","TAFT, LA",2023-07-07,11,10,-1
3630181159,"BURNS HARBOR, IN","BURNS HARBOR, IN",2023-07-07,6,3,-3
3630149076,"WYLIE, TX","JACKSONVILLE, FL",2023-07-07,10,9,-1
3630155784,"ICTF, CA","GEORGETOWN, KY",2023-07-07,7,9,2
3630072059,"CHAPMAN, PA","APPLE GROVE, WV",2023-07-07,3,5,2
1087547813,"LATHROP, CA","MORRISVILLE, PA",2023-07-07,1,4,3
3630099239,"LULING, LA","AUGUSTA, GA",2023-07-07,5,8,3
3630060688,"CHICAGO, IL","CINCINNATI, OH",2023-07-07,3,4,1
3630178326,"CHARLOTTE, NC","CEDAR CITY, UT",2023-07-07,0,3,3
3630180470,"LOS ANGELES, CA","MORRISVILLE, PA",2023-07-07,4,5,1
3630115001,"LOS ANGELES, CA","RUTHERFORD, PA",2023-07-07,3,1,-2
1087691963,"CINCINNATI, OH","OAKLAND, CA",2023-07-07,1,2,1
3630129644,"SAINT JOHN, NB","MACON, GA",2023-07-07,9,9,0
1087544213,"ROSSER, GA","BARNESVILLE, GA",2023-07-07,4,2,-2
3630112249,"MAHRT (CCH), AL","PORT WENTWORTH, GA",2023-07-07,4,6,2
3630188541,"LATHROP, CA","AUSTELL, GA",2023-07-07,5,7,2
1087624479,"PINEVILLE, NC","AUGUSTA, MS",2023-07-07,-1,1,2
1087552575,"AMELIA, TX","THOMASVILLE, NC",2023-07-07,7,8,1
3630137655,"BLYTHEWOOD, SC","BLOOMINGTON, TX",2023-07-07,5,8,3
3630052562,"BLUFFTON, IN","SELMA, NC",2023-07-06,5,8,3
1087493462,"DORAVILLE, GA","ENGEN, BC",2023-07-07,8,6,-2
3630125632,"GASTONIA, NC","READING, PA",2023-07-07,7,4,-3
3630081799,"BUTLER, IN","CONCORD, ON",2023-07-07,9,6,-3
3630148478,"DAYTON, TX","SIDNEY, OH",2023-07-07,1,3,2
1087679929,"PINEVILLE, NC","NAIRN, ON",2023-07-07,2,1,-1
3630098924,"ASHEVILLE, NC","PINE BLUFF, AR",2023-07-07,7,9,2
3630151439,"23RD STREET, TN","BENTONITE, WY",2023-07-04,9,9,0
3629138800,"SANDUSKY DOCK, OH","CROOKED CREEK MINE, PA",2023-07-07,8,8,0
3630093445,"WADSWORTH, TX","MORRISTOWN, TN",2023-07-07,5,8,3
3630113839,"LOUISVILLE FAIRGR, KY","STE GENEVIEVE, MO",2023-07-07,1,4,3
3630077677,"SAN BERNARDINO, CA","KANSAS CITY, MO",2023-07-07,-1,1,2
1087626471,"BUCYRUS, OH","DET JEFFERSON, MI",2023-07-07,9,7,-2
3630066626,"SAN BERNARDINO, CA","CHARLOTTE, NC",2023-07-07,7,9,2
3630076265,"MERIDIAN, MS","AUSTELL, GA",2023-07-02,3,6,3
3628723377,"LAMBERTS POINT, VA","TOMS CREEK, VA",2023-07-07,5,7,2
3630142804,"WYLIE, TX","ATLANTA, GA",2023-07-07,4,1,-3
1087689186,"CANNELTON (KNWA), WV","LAMBERTS POINT, VA",2023-07-07,10,8,-2
3630189050,"GREENFIELD, MA","DELTA, OH",2023-07-07,10,9,-1
1087536650,"HARRISBURG, PA","SAN BERNARDINO, CA",2023-07-07,0,1,1
3630164327,"WATERVILLE, OH","SHULER, SC",2023-07-07,6,4,-2
3630205424,"WINSLOW, IN","FT WAYNE, IN",2023-07-07,2,1,-1
3630149173,"MACON, GA","SAVANNAH, GA",2023-07-07,9,10,1
3630209046,"MAHANOY CITY, PA","BILLINGS, MT",2023-07-07,3,6,3
3630117786,"KANSAS CITY, MO","NORTH CHARLESTON, SC",2023-07-07,6,9,3
1087687605,"KAPUSKASING, ON","HERNDON, PA",2023-07-07,-1,2,3
1087537224,"MONROE, MI","CHICAGO, IL",2023-07-02,9,6,-3
3628671821,"LAMBERTS POINT, VA","TOMS CREEK, VA",2023-07-07,3,6,3
3630145690,"CITY OF INDUSTRY, CA","PITTSBURGH, PA",2023-07-07,4,3,-1
3630133318,"SELKIRK, NY","BUFFALO, NY",2023-07-07,3,6,3
3630208943,"MAHANOY CITY, PA","MYERS, ID",2023-07-06,9,8,-1
3629775254,"LAMBERTS POINT, VA","TOMS CREEK, VA",2023-07-02,1,2,1
3628757017,"CAROL, IN","FRANCISCO, IN",2023-07-07,9,10,1
3630131332,"KANKAKEE, IL","DALTON, GA",2023-07-07,4,2,-2
1087685213,"MOBILE, AL","LEMOYNE, AL",2023-07-07,5,2,-3
1087697163,"HARRISBURG, PA","CHICAGO, IL",2023-07-07,10,8,-2
3630081498,"WESTLAND, PA","CHALMETTE, LA",2023-07-03,11,9,-2
1086106046,"WINSTON-SALEM, NC","WHITE PIGEON, MI",2023-07-07,9,9,0
1087561532,"HYCO, NC","BAILEY MINE, PA",2023-07-07,10,7,-3
1087549629,"HARRISBURG, PA","LATHROP, CA",2023-07-07,2,2,0
1087690959,"FARMERS VALLEY, PA","WOODS CROSS, UT",2023-07-07,3,4,1
3630135920,"BOWDEN YARD, FL","PORTLAND, OR",2023-07-07,2,3,1
1087552761,"LANDERS, IL","LANDERS, IL",2023-07-07,4,6,2
3630164652,"JACKSONVILLE, FL","RUTHERFORD, PA",2023-07-07,12,9,-3
3630175946,"EAST BRAINTREE, MA","ROBY, IN",2023-07-07,7,7,0
3630143355,"JEFFERSONVILLE, IN","LOUISVILLE, KY",2023-07-07,4,5,1
1087629160,"LAMBERTS POINT, VA","WILLIAMSON YARD, WV",2023-07-07,3,1,-2
1087550743,"CHICAGO 47TH ST TV, IL","CROXTON, NJ",2023-07-07,6,3,-3
3630092130,"TALLADEGA, AL","PINE, IN",2023-07-07,8,7,-1
3630098021,"BELLEVUE, OH","TOLEDO, OH",2023-07-07,9,9,0
3630171853,"EAST ST LOUIS, IL","FALCONBRIDGE, ON",2023-07-07,0,2,2
3630056469,"LAMBERTS POINT, VA","WILLIAMSON YARD, WV",2023-07-07,6,3,-3
3630138279,"COLUMBIA (CORY), PA","SCIO, OH",2023-07-07,0,2,2
3630137516,"MUNCY (LVRR), PA","LORDSTOWN, OH",2023-07-07,4,2,-2
3630122058,"ATLANTA, GA","CALVERT, AL",2023-07-07,6,5,-1
3630056215,"MERIDIAN, MS","AUSTELL, GA",2023-07-07,5,8,3
1087614513,"FARRELL, PA","BUTLER, IN",2023-07-07,5,8,3
1087541621,"CINCINNATI, OH","CALUMET, IL",2023-07-07,8,6,-2
3630098306,"NEW BERN, NC","BURNSVILLE, MS",2023-07-07,11,9,-2
3630185234,"GARY, IN","MIDWEST PORTAGE, IN",2023-07-07,3,1,-2
1087701344,"LOS ANGELES, CA","AUSTELL, GA",2023-07-07,12,9,-3
1087561207,"HYCO, NC","BAILEY MINE, PA",2023-07-07,7,7,0
1087645548,"TOLEDO, OH","LAUREL, MT",2023-07-07,7,6,-1
1087690828,"SANDERSVILLE, GA","WEST MONROE, LA",2023-07-07,9,6,-3
1087709902,"NEW ORLEANS, LA","NEW ORLEANS, LA",2023-07-07,6,6,0
3630209800,"FT WAYNE, IN","PIEDRAS NEGRAS, CU",2023-07-07,4,7,3
1087559991,"CALVERT, AL","INDIANA HARBOR, IN",2023-07-07,4,1,-3
3630121581,"INSTITUTE (KNWA), WV","TAFT, LA",2023-07-07,12,9,-3
3630164628,"PARKERSBURG, WV","WOODBURN, IN",2023-07-07,0,2,2
3630144092,"WANETA, BC","CHATTANOOGA, TN",2023-07-07,10,10,0
3630064959,"SALINAS VICTORIA, NL","AUSTELL, GA",2023-07-07,5,2,-3
1087637456,"DECATUR, IL","HOMER, IL",2023-07-07,7,4,-3
1087681154,"CANTON, OH","WAUPACA, WI",2023-07-05,9,10,1
1087003241,"SURRENCY, GA","ANDERSON (ICRK), IN",2023-07-07,5,6,1
3630095340,"GATEWAY MINE, IL","WHEATFIELD, IN",2023-07-07,4,2,-2
3630159453,"TIFTON, GA","LUBBOCK, TX",2023-07-07,1,3,2
1087699589,"GRIFFITH, NC","SAVANNAH, GA",2023-07-07,8,7,-1
3630125284,"BURNS HARBOR, IN","BURNS HARBOR, IN",2023-07-07,6,8,2
3630197079,"SANDERSVILLE, GA","WEST MONROE, LA",2023-07-07,8,5,-3
3630169717,"MILLSDALE, IL","GIANT, SC",2023-07-07,6,3,-3
1087622265,"HUNTSVILLE, AL","GARDEN CITY, GA",2023-07-07,8,8,0
3630135742,"NIAGARA FALLS, NY","REYBOLD, DE",2023-07-07,3,3,0
3630188389,"TACOMA EXPORT, WA","COLUMBUS, OH",2023-07-07,3,1,-2
3630189547,"COLUMBIA CITY, IN","ST LOUIS, MO",2023-07-07,1,4,3
1087711501,"MAUMEE, OH","REYBOLD, DE",2023-07-07,9,6,-3
3630182171,"SELKIRK, NY","LAFAYETTE, IN",2023-07-07,5,6,1
3630123907,"HUNTSVILLE, AL","SCOTTSBORO, AL",2023-07-06,7,4,-3
3629821071,"SURRENCY, GA","ANDERSON (ICRK), IN",2023-07-07,4,5,1
3630055293,"LAMBERTS POINT, VA","WILLIAMSON YARD, WV",2023-07-07,0,3,3
1087688588,"LAMBERTS POINT, VA","WILLIAMSON YARD, WV",2023-07-07,5,5,0
1087544459,"ROSSER, GA","BARNESVILLE, GA",2023-07-07,5,6,1
3630149212,"SAN BERNARDINO, CA","JACKSONVILLE, FL",2023-07-07,2,3,1
3630126531,"GARLAND, TX","ASHEBORO, NC",2023-07-07,-1,1,2
3630094239,"ROCHESTER-5, NY","TRACY, CA",2023-07-07,10,9,-1
3630065484,"MIDLAND, NC","FREEPORT, TX",2023-07-07,9,8,-1
3630183923,"NORFOLK INTERNATION, VA","LANDERS, IL",2023-07-07,13,10,-3
1087665475,"JACKSONVILLE, FL","ST LOUIS, MO",2023-07-04,2,5,3
3629195624,"LAMBERTS POINT, VA","TOMS CREEK, VA",2023-07-07,0,3,3
3630176976,"FAIRFAX, KS","WALKERTOWN, NC",2023-07-07,5,8,3
3630071582,"LAMBERTS POINT, VA","WILLIAMSON YARD, WV",2023-07-07,4,5,1
3630172639,"WYLIE, TX","CROXTON, NJ",2023-07-07,5,5,0
3630178805,"LOS ANGELES, CA","AUSTELL, GA",2023-07-07,5,7,2
3630097342,"CANDOR, NC","PORTLAND, IN",2023-07-07,0,2,2
3630149343,"CEDAR CITY, UT","CHARLOTTE, NC",2023-07-07,2,5,3
3630108648,"CLYMERS, IN","ALBION, MI",2023-07-07,7,4,-3
3630111293,"WAYNESBORO, VA","UNION BRIDGE, MD",2023-07-07,7,8,1
3630096299,"BUFFALO, NY","BUFFALO, NY",2023-07-07,3,2,-1
3630057677,"LONG BEACH E PIER, CA","CLEVELAND, OH",2023-07-07,6,8,2
1087641756,"CHICAGO, IL","HARRISBURG, PA",2023-07-07,3,2,-1
3630104898,"KANSAS CITY, MO","CRAWFORDSVILLE, IN",2023-07-07,11,9,-2
3630104474,"KRANNERT, GA","ST LOUIS, MI",2023-07-07,4,7,3
3630118627,"CRESSON, PA","CLEVELAND, OH",2023-07-07,6,9,3
3630181167,"TOLEDO, OH","COLUMBIA CITY, IN",2023-07-07,10,9,-1
3630097724,"LOS ANGELES, CA","RUTHERFORD, PA",2023-07-07,-1,1,2
1087683114,"LATHROP, CA","HARRISBURG, PA",2023-07-07,3,3,0
3630139843,"DECATUR, IL","HAPEVILLE, GA",2023-07-07,1,3,2
3630130506,"UNION BRIDGE, MD","DURHAM, NC",2023-07-07,10,7,-3
3630196382,"TITUSVILLE, FL","SAN BERNARDINO, CA",2023-07-07,5,8,3
3630069098,"ROSSER, GA","BARNESVILLE, GA",2023-07-06,4,1,-3
1087266310,"LAMBERTS POINT, VA","TOMS CREEK, VA",2023-07-07,6,7,1
3630210217,"BROOKLAWN, LA","RINCON, GA",2023-07-07,7,4,-3
3630091100,"WINSTON-SALEM, NC","WHITE PIGEON, MI",2023-07-07,5,2,-3
1087642833,"DALLAS, TX","CROXTON, NJ",2023-07-07,4,6,2
3630177964,"GEISMAR, LA","VANDALIA, NC",2023-07-07,7,5,-2
3630084137,"CALVERT, AL","INDIANA HARBOR, IN",2023-07-07,10,9,-1
1087528982,"CHICAGO ENGLEW TV, IL","BUFFALO, NY",2023-07-07,6,5,-1
1087694539,"LAKE CHARLES, LA","ASHEBORO, NC",2023-07-07,8,10,2
1087594446,"CLEVELAND, OH","MIDWEST PORTAGE, IN",2023-07-07,3,1,-2
3630119275,"DEVON, KY","FORMOSA, TX",2023-07-07,8,5,-3
3630085476,"MEMPHIS, TN","CALVERT, AL",2023-07-07,6,8,2
3630217104,"AUGUSTA, GA","DONORA, PA",2023-07-07,4,3,-1
3630132168,"TRACY, PQ","LOUISVILLE, KY",2023-07-06,3,4,1
3629795822,"LAMBERTS POINT, VA","TOMS CREEK, VA",2023-07-07,4,4,0
3630145608,"BIRMINGHAM, MO","DETROIT DEARBORN, MI",2023-07-07,0,1,1
1087666162,"KENNEY YARD, PA","KENNEY YARD, PA",2023-07-07,7,6,-1
3630096948,"NORCO, LA","ELIZABETH, NJ",2023-07-07,2,3,1
3630157540,"BURNS HARBOR, IN","BURNS HARBOR, IN",2023-07-07,7,7,0
3630151007,"DECATUR, IL","HOMER, IL",2023-07-07,10,7,-3
3630199283,"WAUSAU, WI","FRANKLIN, OH",2023-07-07,4,7,3
1087610802,"RIVER ROUGE, MI","DETROIT, MI",2023-07-07,8,7,-1
3630211849,"WINSTON-SALEM, NC","HOBBS, IN",2023-07-07,2,5,3
3630131714,"NORTH CHARLESTON, SC","FOREST PARK, GA",2023-07-07,3,3,0
1087712256,"DECATUR, AL","BAYPORT, TX",2023-07-07,-1,2,3
1087582821,"CLAY, DE","THOMASTON, IN",2023-07-07,3,4,1
1087549263,"SOUTH SEATTLE, WA","HARRISBURG, PA",2023-07-07,2,5,3
3630205725,"WARRENTON, OH","SPARTA, WI",2023-07-07,8,5,-3
1087538791,"CHARLOTTE, NC","SAN BERNARDINO, CA",2023-07-07,2,5,3
3630151502,"PONCA CITY, OK","FINDLAY, OH",2023-07-07,10,9,-1
3630084527,"BUFFALO BISON, NY","GEORGETOWN, KY",2023-07-07,8,5,-3
3630092376,"WAYNESBURG, PA","BETHLEHEM, PA",2023-07-07,6,3,-3
3630109995,"LOUISVILLE, KY","LOUISVILLE, KY",2023-07-07,7,10,3
3630188054,"NATKA (AIKR), SC","LAKE CHARLES, LA",2023-07-07,10,8,-2
3630133368,"SELKIRK, NY","BUFFALO, NY",2023-07-07,1,3,2
3630179453,"LAMBERTS POINT, VA","WILLIAMSON YARD, WV",2023-07-07,3,6,3
3630086561,"ROCHESTER-5, NY","TRACY, CA",2023-07-07,0,1,1
3630172469,"NORTH CHARLESTON, SC","NIXON, GA",2023-07-07,7,9,2
3630094132,"MEMPHIS, TN","JACKSONVILLE, FL",2023-07-07,2,2,0
3630072172,"CLEBURNE, TX","CHESAPEAKE, VA",2023-07-07,5,8,3
3630133889,"LAMBERTS POINT, VA","WILLIAMSON YARD, WV",2023-07-07,7,6,-1
1087577737,"GATEWAY MINE, IL","WHEATFIELD, IN",2023-07-07,0,3,3
3630060078,"KANSAS CITY, MO","KANSAS CITY, MO",2023-07-07,10,7,-3
1087528851,"RUTHERFORD, PA","ST LOUIS, MO",2023-07-07,6,3,-3
3630103216,"CHARLES TOWN RANSON, WV","STATESBORO, GA",2023-07-07,9,6,-3
3630109791,"LOUISVILLE, KY","LOUISVILLE, KY",2023-07-07,-1,2,3
1087652236,"EDGERTON, IN","CANA, FL",2023-07-07,4,7,3
3630137590,"ROBINSON, IL","DRAGON, MS",2023-07-07,-1,2,3
1087665938,"PITTSBURGH, PA","ELIZABETH MARINE TE, NJ",2023-07-07,5,6,1
3630137150,"MUNCY (LVRR), PA","LORDSTOWN, OH",2023-07-07,2,4,2
1087532410,"CHICAGO, IL","PITTSBURGH, PA",2023-07-07,2,3,1
3630071095,"KANSAS CITY, MO","WANETA, BC",2023-07-07,3,1,-2
3630108779,"CLYMERS, IN","CLYMERS, IN",2023-07-07,0,1,1
3630111188,"EL DORADO, AR","HOPEWELL, VA",2023-07-07,8,6,-2
3630072944,"LOS ANGELES, CA","CROXTON, NJ",2023-07-07,3,2,-1
3630189335,"ELKHART, IN","SELMA, MO",2023-07-07,2,1,-1
1087588958,"BAYTOWN, TX","NORCROSS, GA",2023-07-07,0,2,2
3630084860,"MEHOOPANY, PA","PHILADELPHIA, PA",2023-07-07,5,8,3
1087625815,"CEDARVILLE, VA","TROUTVILLE, VA",2023-07-07,7,9,2
3630195598,"DECATUR, AL","FRANKLIN, IN",2023-07-07,2,5,3
1087594959,"BLACKSBURG, SC","PALMERTON, PA",2023-07-07,11,9,-2
3630062185,"BELLEVUE, OH","BELLEVUE, OH",2023-07-07,5,3,-2
3630087478,"KANSAS CITY, MO","MELVINDALE, MI",2023-07-07,6,4,-2
3630065515,"DECATUR, IL","DECATUR, IL",2023-07-07,5,4,-1
3630118847,"FARMERS VALLEY, PA","HOUSTON, TX",2023-07-07,2,1,-1
3630099441,"THOMASVILLE, PA","ALCHEM, WY",2023-07-07,7,5,-2
3630185983,"GEORGETOWN, KY","MIRA LOMA, CA",2023-07-07,8,10,2
3630193978,"BAYONNE, NJ","CHICAGO, IL",2023-07-07,9,10,1
3630172980,"DETROIT DEARBORN, MI","BIRMINGHAM, MO",2023-07-07,10,7,-3
3630094069,"MEMPHIS, TN","JACKSONVILLE, FL",2023-07-07,5,4,-1
3630074174,"BAYPORT, TX","DECATUR, AL",2023-07-07,7,6,-1
3630077203,"CALVERT, AL","DECATUR, AL",2023-07-07,2,5,3
3630146515,"PRATTVILLE, AL","THREE RIVERS, MI",2023-07-02,2,2,0
3628755691,"CAROL, IN","FRANCISCO, IN",2023-07-07,0,2,2
3630155726,"CHICAGO, IL","CHICAGO MIX CTR, IL",2023-07-07,1,3,2
3630092994,"WAYNESBURG, PA","BETHLEHEM, PA",2023-07-02,7,6,-1
3628755918,"CAROL, IN","FRANCISCO, IN",2023-07-07,9,8,-1
1087535206,"CALVERT, AL","PORTSMOUTH, OH",2023-07-07,3,1,-2
1087667582,"CHARLESTON, SC","GREER, SC",2023-07-07,11,9,-2
3630117150,"ROSSVILLE, TN","ROSSVILLE, TN",2023-07-07,8,5,-3
3630203595,"WARRENTON, OH","SPARTA, WI",2023-07-07,9,7,-2
1087567520,"JACKSONVILLE, FL","CINCINNATI, OH",2023-07-07,5,8,3
3630162456,"BRUNSWICK, GA","ARMSTRONG, GA",2023-07-02,4,5,1
3628723123,"LAMBERTS POINT, VA","TOMS CREEK, VA",2023-07-04,5,4,-1
3629131785,"SANDUSKY DOCK, OH","CROOKED CREEK MINE, PA",2023-07-07,3,4,1
3630081082,"HYCO, NC","BAILEY MINE, PA",2023-07-07,10,8,-2
3630205571,"ROCKPORT, IN","MANSFIELD, OH",2023-07-07,6,9,3
1087610331,"MELVINDALE, MI","KANSAS CITY, MO",2023-07-07,8,8,0
1087667087,"BALTIMORE DUNDALK M, MD","CHICAGO, IL",2023-07-07,13,10,-3
1087686015,"BIRMINGHAM, MO","DETROIT DEARBORN, MI",2023-07-07,9,8,-1
3630172134,"ADDIS, LA","SOUTH ANDERSON, SC",2023-07-07,8,9,1
3630056207,"MERIDIAN, MS","AUSTELL, GA",2023-07-07,5,8,3
1087665881,"DETROIT, MI","PORTSMOUTH APMT, VA",2023-07-07,-2,1,3
1087672236,"PALMERTON, PA","BLACKSBURG, SC",2023-07-07,0,3,3
1087550175,"CITY OF INDUSTRY, CA","TOLEDO, OH",2023-07-07,7,4,-3
3630128884,"BURNS HARBOR, IN","BURNS HARBOR, IN",2023-07-07,7,9,2
1087597949,"LANDERS, IL","CLEVELAND, OH",2023-07-07,2,5,3
3630072368,"THOMASVILLE, PA","SIDNEY, IL",2023-07-07,1,1,0
3630175108,"HOUSTON, TX","MORRISVILLE, PA",2023-07-07,1,3,2
3630190580,"PLYMOUTH MEETING, PA","WILTON, AL",2023-07-07,5,2,-3
3630052368,"BLUFFTON, IN","SELMA, NC",2023-07-07,11,10,-1
1087715393,"BAINBRIDGE, GA","SANDERSVILLE, MS",2023-07-07,4,1,-3
1087577672,"GATEWAY MINE, IL","WHEATFIELD, IN",2023-07-07,12,10,-2
1087715571,"DECATUR, AL","COLUMBUS, OH",2023-07-07,5,4,-1
3630105187,"LOS ANGELES, CA","JACKSONVILLE, FL",2023-07-07,5,3,-2
3630125129,"BURNS HARBOR, IN","BURNS HARBOR, IN",2023-07-07,7,8,1
3630187870,"MIAMI, FL","JACKSONVILLE, FL",2023-07-07,6,4,-2
3630177003,"FAIRFAX, KS","WALKERTOWN, NC",2023-07-07,9,9,0
3630150920,"DECATUR, IL","HOMER, IL",2023-07-07,5,4,-1
1087563209,"CALVERT, AL","INDIANA HARBOR, IN",2023-07-07,6,7,1
3630116138,"PUERTO CARROZAS, GJ","ROCKPORT, IN",2023-07-07,5,6,1
3630149262,"COLUMBIA, SC","ELKHART, IN",2023-07-07,6,7,1
3630076689,"RANDOLPH, MO","ELIZABETHTOWN, KY",2023-07-07,-2,1,3
1087613038,"MALLARD, AL","DECATUR, AL",2023-07-07,0,2,2
3630107773,"SANDUSKY DOCK, OH","CROOKED CREEK MINE, PA",2023-07-07,6,8,2
3630130271,"BUFFALO, NY","LEE CREEK, NC",2023-07-07,9,9,0
3630079548,"STOCKTON, CA","HARRISBURG, PA",2023-07-07,3,1,-2
1087618826,"BELLEFONTE, PA","BESSEMER, PA",2023-07-07,8,8,0
3630089975,"MERIDIAN, MS","MIAMI, FL",2023-07-07,6,7,1
3630072562,"COORS CROSSING, VA","EDDYVILLE, IA",2023-07-07,9,8,-1
3630140527,"ROANOKE, VA","CHICAGO, IL",2023-07-07,7,10,3
1087520976,"AUSTELL INTERMODAL, GA","ATLANTA, GA",2023-07-07,7,4,-3
3630116471,"LOS ANGELES, CA","AUSTELL, GA",2023-07-07,3,3,0
3630086082,"FINDERNE, NJ","CHOCOLATE BAYOU, TX",2023-07-07,5,7,2
3630066579,"INTERPUERTO, SL","AUSTELL, GA",2023-07-07,3,3,0
1087652464,"WAYNE, MI","BUTLER, IN",2023-07-07,7,8,1
1087645360,"TAYLOR, PA","TACSIM, WA",2023-07-07,6,7,1
1087530654,"BELLEVUE, OH","BELLEVUE, OH",2023-07-07,1,1,0
3630092504,"WAYNESBURG, PA","BETHLEHEM, PA",2023-07-07,3,5,2
3630090104,"HAPEVILLE, GA","LOUDON, TN",2023-07-07,7,6,-1
3630199178,"LATHROP, CA","CINCINNATI, OH",2023-07-07,11,10,-1
1087708736,"LOUISVILLE FAIRGR, KY","ANCHORAGE, LA",2023-07-07,5,6,1
3630096011,"FOSTORIA, OH","CHICAGO, IL",2023-07-07,1,3,2
1087623059,"WEST HAZLETON, PA","ORANGE, TX",2023-07-07,0,3,3
3630212552,"WINSTON-SALEM, NC","HOBBS, IN",2023-07-07,7,10,3
3630075926,"MERIDIAN, MS","CHARLOTTE, NC",2023-07-07,7,8,1
1087620768,"ABRAMS, PA","PORT CLINTON, PA",2023-07-07,10,8,-2
1087592973,"NORFOLK, NE","PORTAGE, IN",2023-07-07,6,5,-1
3630100412,"EVANSVILLE, IN","BAYPORT, TX",2023-07-07,7,5,-2
3630157299,"BURNS HARBOR, IN","BURNS HARBOR, IN",2023-07-07,1,3,2
1087644021,"CHICAGO, IL","BETHINTERMODAL, PA",2023-07-07,0,2,2
3630155734,"CHICAGO, IL","CHICAGO MIX CTR, IL",2023-07-07,1,1,0
3630177192,"YORKTON, SK","DECATUR, IL",2023-07-07,8,9,1
1087688245,"TULSA, OK","HARTFORD, IL",2023-07-07,0,2,2
1087581605,"ASHEVILLE, NC","BAYWAY, NJ",2023-07-07,11,9,-2
3630108402,"VALDOSTA, GA","BURNSVILLE, MS",2023-07-07,10,7,-3
1087536391,"MORRISVILLE TV, PA","ROSSVILLE, TN",2023-07-07,2,5,3
3630074970,"SPRING, TX","SHELBYVILLE, KY",2023-07-07,2,5,3
3630118855,"TYNER, TN","TYNER, TN",2023-07-07,2,1,-1
3630124490,"ERIE, PA","SARNIA, ON",2023-07-07,5,6,1
3630216904,"BUFFALO, NY","BUFFALO, NY",2023-07-07,0,1,1
3630210461,"CHICAGO, IL","CHICAGO MIX CTR, IL",2023-07-07,12,9,-3
3630132956,"SELKIRK, NY","BUFFALO, NY",2023-07-07,2,4,2
3630069959,"WYLIE, TX","ATLANTA, GA",2023-07-07,4,1,-3
3630190475,"PHOENIX, AZ","HARRISBURG, PA",2023-07-07,-2,1,3
3630121890,"HAMILTON, ON","SHARON, PA",2023-07-07,2,4,2
3630076249,"MERIDIAN, MS","AUSTELL, GA",2023-07-07,3,4,1
1087549093,"SAN BERNARDINO, CA","CHARLOTTE, NC",2023-07-07,0,3,3
1087713244,"LADSON, SC","SAN BERNARDINO, CA",2023-07-07,9,8,-1
3630093932,"MEMPHIS, TN","CHARLOTTE, NC",2023-07-07,11,10,-1
3630079085,"WINSTON-SALEM, NC","CLAYPOOL, IN",2023-07-07,1,3,2
1087713820,"AUGUSTA, GA","DONORA, PA",2023-07-07,4,3,-1
1087558521,"TOLEDO, OH","TOLEDO, OH",2023-07-07,-1,1,2
3630060638,"CHICAGO, IL","CINCINNATI, OH",2023-07-07,5,2,-3
3630148363,"NEVILLE ISLAND, PA","BUTLER, IN",2023-07-07,9,7,-2
1087565879,"AUBURN, ME","KANKAKEE, IL",2023-07-07,4,7,3
3630054962,"DECATUR, AL","LINDE, TN",2023-07-07,3,5,2
3630068644,"CHICAGO, IL","COLUMBUS, OH",2023-07-07,5,4,-1
3630182278,"SELKIRK, NY","LAFAYETTE, IN",2023-07-07,0,3,3
3630175190,"LATC, CA","HARRISBURG, PA",2023-07-07,3,2,-1
3630218671,"BAINBRIDGE, GA","SANDERSVILLE, MS",2023-07-07,8,5,-3
3630069446,"SELMA, AL","GREENVILLE, NJ",2023-07-07,6,3,-3
3630100048,"CHICAGO, IL","CHICAGO, IL",2023-07-07,5,7,2
1087636696,"CHICAGO HEIGHTS, IL","BIRMINGHAM, MO",2023-07-07,5,6,1
3630148525,"DECATUR, IL","DECATUR, IL",2023-07-07,1,3,2
1087532143,"HARRISBURG, PA","CHICAGO, IL",2023-07-07,1,4,3
1087535191,"HARRISBURG, PA","STOCKTON, CA",2023-07-07,10,8,-2
3630069111,"BIRMINGHAM, MO","DETROIT DEARBORN, MI",2023-07-07,12,9,-3
1087675616,"SELKIRK, NY","LAFAYETTE, IN",2023-07-07,2,4,2
3630133017,"SELKIRK, NY","BUFFALO, NY",2023-07-07,5,3,-2
1087567211,"PRINCETON, IN","BENICIA, CA",2023-07-07,2,1,-1
1087541168,"LANDERS, IL","LANDERS, IL",2023-07-07,1,3,2
1087684746,"ANDERSONVILLE, GA","SAVANNAH, GA",2023-07-07,10,8,-2
3630198287,"COLQUITT, GA","LEXINGTON (RJCC), KY",2023-07-07,-2,1,3
3630058796,"LONG BEACH E PIER, CA","COLUMBUS, OH",2023-07-07,-2,1,3
3630093958,"MEMPHIS, TN","CHARLOTTE, NC",2023-07-03,2,4,2
3629125750,"SANDUSKY DOCK, OH","CROOKED CREEK MINE, PA",2023-07-07,6,4,-2
1087704643,"MAHANOY CITY, PA","BILLINGS, MT",2023-07-07,11,9,-2
3630212332,"SAN BERNARDINO, CA","CROXTON, NJ",2023-07-07,1,4,3
3630125195,"BURNS HARBOR, IN","BURNS HARBOR, IN",2023-07-07,8,7,-1
3630142723,"ATCHISON, KS","NORCROSS, GA",2023-07-07,8,6,-2
3630068416,"CHICAGO, IL","CROXTON, NJ",2023-07-07,11,9,-2
3630197647,"ALLEMANIA, LA","PORT WENTWORTH, GA",2023-07-07,12,9,-3
3630197320,"NORTH BIRMINGHAM, AL","SPOCARI, AL",2023-07-07,9,8,-1
1087531105,"BELLEVUE, OH","BELLEVUE, OH",2023-07-07,4,4,0
1087580730,"NORFOLK, VA","NORFOLK, VA",2023-07-07,9,9,0
1087530044,"WYLIE, TX","CHARLOTTE, NC",2023-07-07,10,10,0
1087587172,"BETHINTERMODAL, PA","PORTLAND, OR",2023-07-07,5,7,2
3630080832,"HYCO, NC","BAILEY MINE, PA",2023-07-07,9,10,1
3630117273,"DES MOINES, IA","DES MOINES, IA",2023-07-07,2,1,-1
3630195328,"NORFOLK INTERNATION, VA","APPLIANCE PARK, KY",2023-07-07,9,6,-3
3630196293,"STATESVILLE, NC","KOSMOSDALE, KY",2023-07-07,5,2,-3
3630116617,"NORTH BEND, OH","ROXANA, IL",2023-07-07,9,8,-1
3630203090,"LAMBERTS POINT, VA","TOMS CREEK, VA",2023-07-07,8,6,-2
3630070227,"SLCIT, UT","HARRISBURG, PA",2023-07-02,3,4,1
3628723107,"LAMBERTS POINT, VA","TOMS CREEK, VA",2023-07-07,7,4,-3
3630182090,"SELKIRK, NY","LAFAYETTE, IN",2023-07-07,4,5,1
1087527287,"MERIDIAN, MS","CHARLOTTE, NC",2023-07-07,2,3,1
1087543592,"CHICAGO, IL","COLUMBUS, OH",2023-07-07,6,8,2
3630217146,"AUGUSTA, GA","DONORA, PA",2023-07-07,12,9,-3
1087678999,"YAZOO CITY, MS","TOMS CREEK, VA",2023-07-07,11,8,-3
1087625784,"SAVANNAH, GA","SAVANNAH, GA",2023-07-07,1,4,3
1087643805,"MORRISVILLE, PA","CHICAGO, IL",2023-07-02,3,3,0
3628722973,"LAMBERTS POINT, VA","TOMS CREEK, VA",2023-07-07,12,10,-2
3630050984,"DECATUR, IL","DECATUR, IL",2023-07-07,3,6,3
1087614610,"BUFFALO, NY","CHICAGO, IL",2023-07-07,3,2,-1
3630057211,"CHICAGO ENGLEW TV, IL","CHICAGO ENGLEW TV, IL",2023-07-07,6,8,2
3630193839,"LAMBERTS POINT, VA","WILLIAMSON YARD, WV",2023-07-07,8,7,-1
3630075528,"DAYVILLE, CT","DECATUR, IL",2023-07-07,6,9,3
3630148240,"PANAMA CITY, FL","ROME, GA",2023-07-02,2,3,1
3628756540,"CAROL, IN","FRANCISCO, IN",2023-07-07,5,5,0
1087530060,"LONG BEACH E PIER, CA","CINCINNATI, OH",2023-07-07,4,4,0
3630079653,"CITY OF INDUSTRY, CA","PITTSBURGH, PA",2023-07-07,2,1,-1
3630087999,"BOWDEN YARD, FL","POSTELL, GA",2023-07-07,-2,1,3
3630133279,"SELKIRK, NY","BUFFALO, NY",2023-07-07,2,3,1
3630133114,"SELKIRK, NY","BUFFALO, NY",2023-07-07,2,2,0
3630093453,"WADSWORTH, TX","CARROLLTON, GA",2023-07-07,4,6,2
3630180129,"CRAWFORDSVILLE, IN","CHICAGO, IL",2023-07-07,11,8,-3
3630186874,"TACOMA EXPORT, WA","COLUMBUS, OH",2023-07-05,4,4,0
1087002473,"SURRENCY, GA","ANDERSON (ICRK), IN",2023-07-07,6,6,0
3630074409,"LOS ANGELES, CA","RUTHERFORD, PA",2023-07-07,5,4,-1
3630146434,"DECATUR, AL","HARRISONVILLE, MO",2023-07-07,2,1,-1
3630140789,"SARNIA, ON","TOLEDO, OH",2023-07-07,6,4,-2
3630078495,"DET JEFFERSON, MI","ALLIANCE, TX",2023-07-07,4,7,3
3630203765,"LOS ANGELES, CA","AUSTELL, GA",2023-07-07,5,7,2
1087542473,"JACKSONVILLE, FL","JACKSONVILLE, FL",2023-07-07,8,6,-2
3630073071,"LOS ANGELES, CA","RUTHERFORD, PA",2023-07-07,7,5,-2
1087676507,"NORFOLK INTERNATION, VA","LANDERS, IL",2023-07-07,3,6,3
1087565471,"NEW ORLEANS, LA","NEW ORLEANS, LA",2023-07-07,7,10,3
3630068806,"COLUMBUS, GA","STE GENEVIEVE, MO",2023-07-07,8,9,1
1087522504,"RUTHERFORD, PA","KANSAS CITY, MO",2023-07-07,11,8,-3
3630057203,"CHICAGO ENGLEW TV, IL","CHICAGO ENGLEW TV, IL",2023-07-07,2,3,1
1087595840,"BLACKSBURG, SC","PALMERTON, PA",2023-07-07,-1,1,2
1087548631,"CANTON, OH","DYER, PA",2023-07-07,6,5,-1
1087638389,"SHARONVILLE, OH","NORFOLK INTERNATION, VA",2023-07-07,9,8,-1
3630059912,"REYBOLD, DE","YULEE, FL",2023-07-07,11,8,-3
3630075324,"LOS ANGELES, CA","RUTHERFORD, PA",2023-07-03,7,7,0
3628888698,"WINSTON-SALEM, NC","WHITE PIGEON, MI",2023-07-07,12,10,-2
3630196324,"JACKSONVILLE, FL","PRINCETON, IN",2023-07-07,1,1,0
1087557664,"SAN BERNARDINO, CA","JACKSONVILLE, FL",2023-07-07,12,9,-3
3630112142,"PEDRICKTOWN, NJ","HOUSTON, TX",2023-07-07,5,8,3
3630151625,"DEARBORN, MI","KNOXVILLE, TN",2023-07-07,8,5,-3
3630062240,"RUTHERFORD, PA","RUTHERFORD, PA",2023-07-07,5,8,3
3630075594,"LOS ANGELES, CA","JACKSONVILLE, FL",2023-07-07,10,7,-3
1087700615,"POSTELL, GA","ODUM, GA",2023-07-07,5,5,0
3630086511,"GREENEVILLE, TN","LIPE, TN",2023-07-07,2,3,1
3630057423,"CHICAGO ASHLAND AVE, IL","APPLIANCE PARK, KY",2023-07-07,12,10,-2
3630146997,"EVE, MO","DECATUR, IL",2023-07-07,10,7,-3
3630069543,"BAYOU PIERRE, LA","CLEVELAND, TN",2023-07-07,4,2,-2
1087596862,"CINCINNATI, OH","CINCINNATI, OH",2023-07-07,0,3,3
3630203066,"LAMBERTS POINT, VA","TOMS CREEK, VA",2023-07-07,5,6,1
1087616125,"BURNS HARBOR, IN","BURNS HARBOR, IN",2023-07-07,4,6,2
3630085955,"BOWDEN YARD, FL","CHARLOTTE, NC",2023-07-02,5,3,-2
3628671520,"CHARLOTTE, NC","WHITE PIGEON, MI",2023-07-07,8,6,-2
3630109822,"LOUISVILLE, KY","LOUISVILLE, KY",2023-07-07,13,10,-3
1087631002,"MELVINDALE, MI","KANSAS CITY, MO",2023-07-07,0,3,3
3630102139,"HOUSTON, TX","NORCROSS, GA",2023-07-07,6,9,3
3630115695,"STEELTON, PA","LACASSINE, LA",2023-07-07,5,2,-3
3630128339,"GUNTERSVILLE, AL","DAWSON, GA",2023-07-05,12,10,-2
1087003217,"SURRENCY, GA","ANDERSON (ICRK), IN",2023-07-07,10,7,-3
3630060696,"CHICAGO, IL","CINCINNATI, OH",2023-07-07,3,1,-2
3630063246,"LAMBERTS POINT, VA","WILLIAMSON YARD, WV",2023-07-07,9,10,1
3630156104,"ELDON, TX","SPRING CITY, TN",2023-07-07,0,3,3
3630056338,"MERIDIAN, MS","AUSTELL, GA",2023-07-07,12,10,-2
3630126442,"DILLEY, TX","PICAYUNE, MS",2023-07-07,2,5,3
1087714410,"LOS ANGELES, CA","CHARLOTTE, NC",2023-07-07,13,10,-3
1087637773,"DECATUR, IL","HOMER, IL",2023-07-07,8,9,1
3630115093,"THATCHER, IN","BIG ISLAND, WY",2023-07-02,4,4,0
3628672005,"LAMBERTS POINT, VA","TOMS CREEK, VA",2023-07-07,1,1,0
1087523526,"BLUFFTON, IN","SELMA, NC",2023-07-07,12,10,-2
3630075879,"MERIDIAN, MS","CHARLOTTE, NC",2023-07-07,2,1,-1
1087538505,"LEIPSIC, OH","CRAWFORDSVILLE, IN",2023-07-07,4,7,3
1087635357,"BIRMINGHAM, MO","DETROIT DEARBORN, MI",2023-07-07,5,5,0
3630070201,"LOS ANGELES, CA","AUSTELL, GA",2023-07-07,3,4,1
3630125234,"BURNS HARBOR, IN","BURNS HARBOR, IN",2023-07-07,2,2,0
3630074344,"LOS ANGELES, CA","RUTHERFORD, PA",2023-07-07,5,4,-1
3630134380,"ADDYSTON, OH","FITCHBURG, MA",2023-07-07,5,2,-3
3630052627,"BLUFFTON, IN","SELMA, NC",2023-07-07,7,7,0
3630138936,"RALSTON, IA","DAYTON, VA",2023-07-07,1,4,3
3630171049,"WYLIE, TX","JACKSONVILLE, FL",2023-07-07,2,4,2
3630069218,"TACOMA BLAIR, WA","COLUMBUS, OH",2023-07-07,8,8,0
3630063107,"WYLIE, TX","JACKSONVILLE, FL",2023-07-07,4,5,1
3630217861,"SEATTLE, WA","NORFOLK INTERNATION, VA",2023-07-07,6,4,-2
1087536862,"QUERETARO, QA","MALLARD, AL",2023-07-07,2,5,3
3630113724,"CINCINNATI, OH","CINCINNATI, OH",2023-07-07,6,8,2
3630171900,"PINE BLUFF, AR","WAYNESVILLE (BLU), NC",2023-07-07,8,10,2
3630113813,"ORANGE, TX","FINDLAY, OH",2023-07-07,7,10,3
3630130661,"DAYTON, OH","CINCINNATI, OH",2023-07-07,13,10,-3
1087695632,"FAIRFAX, KS","MELVINDALE, MI",2023-07-07,7,5,-2
3630145886,"LAMBERTS POINT, VA","WILLIAMSON YARD, WV",2023-07-07,-2,1,3
3630171104,"YOUNGSTOWN, OH","NORTH BERGEN, NJ",2023-07-07,-1,1,2
1087621489,"HARRISBURG, PA","HARRISBURG, PA",2023-07-07,5,3,-2
3630072148,"LATHROP, CA","HARRISBURG, PA",2023-07-07,5,3,-2
1087607859,"GEORGETOWN, KY","CLEVELAND, OH",2023-07-07,3,5,2
3630086171,"LOS ANGELES, CA","RUTHERFORD, PA",2023-07-07,3,6,3
1087649924,"TIFTON, GA","LUBBOCK, TX",2023-07-07,10,10,0
3630203715,"LAMBERTS POINT, VA","TOMS CREEK, VA",2023-07-07,11,10,-1
3630138172,"CEDARVILLE, VA","TROUTVILLE, VA",2023-07-07,6,6,0
3630213558,"NEW CASTLE, PA","NEW ORLEANS, LA",2023-07-06,8,8,0
1087461473,"WINSTON-SALEM, NC","WHITE PIGEON, MI",2023-07-07,3,4,1
1087529768,"ST LOUIS, MO","PORTSMOUTH APMT, VA",2023-07-07,5,5,0
1087667427,"LATHROP, CA","CHARLOTTE, NC",2023-07-04,4,4,0
3629173630,"SANDUSKY DOCK, OH","CROOKED CREEK MINE, PA",2023-07-07,4,4,0
3630212641,"WINSTON-SALEM, NC","HOBBS, IN",2023-07-07,2,5,3
1087544441,"ROSSER, GA","BARNESVILLE, GA",2023-07-07,8,6,-2
1087620815,"ROSSVILLE, TN","GARDEN CITY, GA",2023-07-07,5,5,0
3630099027,"ASHEVILLE, NC","HANNA, OH",2023-07-07,9,8,-1
1087545722,"LOS ANGELES, CA","AUSTELL, GA",2023-07-06,1,1,0
3629821089,"SURRENCY, GA","ANDERSON (ICRK), IN",2023-07-07,5,8,3
3630141557,"LAMBERTS POINT, VA","WILLIAMSON YARD, WV",2023-07-07,11,9,-2
1087581370,"NORFOLK, VA","NORFOLK, VA",2023-07-07,7,10,3
3630194704,"FARMERS VALLEY, PA","WOODS CROSS, UT",2023-07-07,3,6,3
1087565853,"GARY, IN","MIDWEST PORTAGE, IN",2023-07-07,9,10,1
1087618567,"CHICAGO, IL","LANDERS, IL",2023-07-04,9,6,-3
1086410932,"SANDUSKY DOCK, OH","CROOKED CREEK MINE, PA",2023-07-07,-1,2,3
1087546728,"CHICAGO, IL","PITTSBURGH, PA",2023-07-07,10,8,-2
3630076142,"MERIDIAN, MS","AUSTELL, GA",2023-07-07,3,6,3
3630096972,"NORCO, LA","ELIZABETH, NJ",2023-07-07,7,7,0
3630052067,"BLUFFTON, IN","SELMA, NC",2023-07-07,3,3,0
3630202866,"LAMBERTS POINT, VA","TOMS CREEK, VA",2023-07-07,-1,1,2
3630118724,"NORTH BEND, OH","ROXANA, IL",2023-07-07,13,10,-3
1087570971,"BOWDEN YARD, FL","BARIN, GA",2023-07-07,7,4,-3
1087601447,"ST LOUIS, MO","RUTHERFORD, PA",2023-07-07,3,3,0
3630142163,"THOMASTON, IN","MONROE, MI",2023-07-07,7,4,-3
3630085824,"BOWDEN YARD, FL","CHICAGO 47TH ST TV, IL",2023-07-07,7,9,2
3630145349,"ELDON, TX","HAZLETON, PA",2023-07-07,8,8,0
3630210071,"EAST ST LOUIS, IL","WENTZVILLE, MO",2023-07-07,3,5,2
3630057083,"LOS ANGELES, CA","RUTHERFORD, PA",2023-07-07,6,4,-2
3630114356,"LANDERS, IL","CICERO, IL",2023-07-07,8,5,-3
3630099904,"CLAY, DE","THOMASTON, IN",2023-07-07,4,5,1
1087673004,"ROSSVILLE, TN","GARDEN CITY, GA",2023-07-07,5,8,3
3630118025,"CRESSON, PA","CRAB ORCHARD, TN",2023-07-07,6,6,0
1087674351,"GILBERTON, PA","DELTA, OH",2023-07-07,0,3,3
3630219083,"ARVIDA, PQ","WARRICK, IN",2023-07-07,7,6,-1
1087648211,"PITTSFIELD, MA","KANKAKEE, IL",2023-07-07,11,9,-2
1087521346,"LAMBERTS POINT, VA","WILLIAMSON YARD, WV",2023-07-07,1,1,0
3630146785,"CINCINNATI, OH","SHARONVILLE, OH",2023-07-07,9,7,-2
3630065620,"MONROE, MI","CHICAGO, IL",2023-07-07,1,2,1
3630074679,"CLEWISTON, FL","TYNER, TN",2023-07-07,3,4,1
1087595921,"MAHRT (CCH), AL","DE RIDDER, LA",2023-07-07,11,10,-1
3630199055,"LEE CREEK, NC","REYBOLD, DE",2023-07-07,7,5,-2
3630076207,"BARSTOW, CA","JACKSONVILLE, FL",2023-07-07,7,4,-3
3630126387,"JACKSON, MI","GARY, IN",2023-07-07,11,10,-1
3630065735,"MONROE, MI","CHICAGO, IL",2023-07-07,9,9,0
3630116976,"KANSAS CITY, MO","MELVINDALE, MI",2023-07-07,8,7,-1
3630199144,"AUGUSTA, GA","WHITBURY, MS",2023-07-07,0,3,3
3630210259,"VOLTZ, MO","EAST ST LOUIS, IL",2023-07-07,11,9,-2
1087612757,"EDGERTON, IN","KINGS CREEK (DCR), MD",2023-07-07,6,4,-2
3630140810,"SARNIA, ON","TOLEDO, OH",2023-07-07,6,8,2
3630171366,"BRUNSWICK, GA","LOZETA, MO",2023-07-07,12,10,-2
3630098762,"ASHEVILLE, NC","PINE BLUFF, AR",2023-07-07,8,9,1
1087693119,"RUTHERFORD, PA","ATLANTA, GA",2023-07-07,4,2,-2
1087664738,"DETROIT DEARBORN, MI","BIRMINGHAM, MO",2023-07-07,10,10,0
1087650137,"FARRELL, PA","PAULSBORO, NJ",2023-07-07,7,7,0
3630125771,"MONETTA, SC","DECATUR, IL",2023-07-07,3,6,3
3630072724,"SANFORD, NC","HAMPTON, GA",2023-07-07,6,6,0
3630205149,"CHARLESTON, SC","GREER, SC",2023-07-07,3,4,1
3630188648,"LAFAYETTE, IN","CLYMERS, IN",2023-07-07,5,3,-2
3630166476,"MENTONE, IN","HANNA, OH",2023-07-07,10,10,0
3630162040,"GREER, SC","CHARLESTON, SC",2023-07-07,5,7,2
3630141060,"ECORSE, MI","BESSEMER, PA",2023-07-07,1,4,3
3630199607,"CEDAR RAPIDS, IA","SPARTANBURG, SC",2023-07-07,5,4,-1
3630085612,"MEMPHIS, TN","DELTA, OH",2023-07-07,4,1,-3
3630199495,"MELVINDALE, MI","KANSAS CITY, MO",2023-07-07,6,6,0
1087565154,"CALVERT, AL","INDIANA HARBOR, IN",2023-07-07,12,9,-3
1087579357,"BATH, PA","YOUNGSTOWN (YB), OH",2023-07-07,7,4,-3
3630108892,"ZANESVILLE, OH","BIG ISLAND, WY",2023-07-07,8,6,-2
1087700657,"POSTELL, GA","SAVANNAH, GA",2023-07-07,2,2,0
3630137605,"ROBINSON, IL","DRAGON, MS",2023-07-07,9,10,1
3630181905,"SELKIRK, NY","LAFAYETTE, IN",2023-07-07,4,4,0
1087582392,"CHICAGO, IL","ELIZABETH MARINE TE, NJ",2023-07-02,3,6,3
3628756370,"CAROL, IN","FRANCISCO, IN",2023-07-07,6,5,-1
3630212764,"RALEIGH, NC","WOODLAWN, AL",2023-07-07,5,3,-2
3630166303,"DES MOINES, IA","DES MOINES, IA",2023-07-07,4,6,2
3630193732,"LAMBERTS POINT, VA","WILLIAMSON YARD, WV",2023-07-07,-1,2,3
3630197126,"SANDERSVILLE, GA","WABASH, IN",2023-07-07,1,1,0
1087700429,"POSTELL, GA","ELLABELL, GA",2023-07-07,3,2,-1
1087567392,"JACKSONVILLE, FL","SAN BERNARDINO, CA",2023-07-07,5,5,0
1087653363,"LACYMARK, FL","JUNCTION CITY, GA",2023-07-07,5,4,-1
3630064894,"MONROE, MI","THUNDER JCT WEST, WY",2023-07-07,6,7,1
3630194233,"GORDON, GA","JACKSON, TN",2023-07-07,5,2,-3
3630168711,"OAKWOOD, MI","GARY, IN",2023-07-02,0,1,1
3628757009,"CAROL, IN","FRANCISCO, IN",2023-07-07,8,7,-1
3630114380,"LANDERS, IL","LANDERS, IL",2023-07-07,0,3,3
1087582643,"FOSTORIA, OH","FOSTORIA, OH",2023-07-07,7,5,-2
3630165828,"JACKSON, AL","CHICAGO, IL",2023-07-07,6,8,2
1087561184,"HYCO, NC","BAILEY MINE, PA",2023-07-07,0,1,1
3630191057,"BAYONNE, NJ","WEST LAKE, LA",2023-07-07,-1,2,3
3630115815,"RED DEER, AB","LOUISVILLE, KY",2023-07-07,6,8,2
3630058102,"LONG BEACH E PIER, CA","COLUMBUS, OH",2023-07-07,1,2,1
1087634644,"SHARONVILLE, OH","SHARONVILLE, OH",2023-07-07,7,10,3
3630177752,"KANSAS CITY, MO","MELVINDALE, MI",2023-07-07,12,10,-2
3630065426,"BIRMINGHAM, MO","DETROIT DEARBORN, MI",2023-07-02,4,7,3
3628722876,"LAMBERTS POINT, VA","TOMS CREEK, VA",2023-07-02,4,6,2
3628671106,"CHARLOTTE, NC","WHITE PIGEON, MI",2023-07-07,12,10,-2
3630058372,"LEIPSIC, OH","PITTSBURGH (AVR), PA",2023-07-07,3,6,3
3630141785,"KANSAS CITY, MO","MELVINDALE, MI",2023-07-07,-1,2,3
3630058835,"BOGALUSA, LA","FT WAYNE, IN",2023-07-07,3,2,-1
1087556498,"RANDOLPH, MO","ELIZABETHTOWN, KY",2023-07-07,0,3,3
1087676484,"NORFOLK INTERNATION, VA","LANDERS, IL",2023-07-07,0,1,1
1087587910,"VENICE, IL","CARLISLE, PA",2023-07-07,4,7,3
3630136714,"LOGISTICS PARK CHIC, IL","CHICAGO, IL",2023-07-07,3,3,0
3630066650,"WYLIE, TX","ATLANTA, GA",2023-07-07,-1,1,2
3630152998,"WYLIE, TX","TITUSVILLE, FL",2023-07-07,2,5,3
1087653177,"RARITAN CENTER, NJ","ROCKAWAY (DD), NJ",2023-07-07,-1,1,2
3630063123,"QUERETARO, QA","MALLARD, AL",2023-07-07,8,6,-2
1087619791,"SELKIRK, NY","BUFFALO, NY",2023-07-07,8,6,-2
3630098241,"NORFOLK, VA","NORFOLK, VA",2023-07-07,6,7,1
3630136617,"CALVERT, AL","BRISTOL, PA",2023-07-07,-1,2,3
3630138855,"SERGEANT BLUFF, IA","SCHOOLCRAFT, MI",2023-07-07,5,5,0
3630058055,"LONG BEACH E PIER, CA","COLUMBUS, OH",2023-07-03,9,7,-2
1086007331,"SANDUSKY DOCK, OH","CROOKED CREEK MINE, PA",2023-07-07,4,4,0
1087689851,"CANNELTON (KNWA), WV","LAMBERTS POINT, VA",2023-07-02,11,10,-1
3628756972,"CAROL, IN","FRANCISCO, IN",2023-07-07,10,10,0
3630111065,"PARIS, IL","BATTLE CREEK, MI",2023-07-07,0,3,3
1087578288,"SHARONVILLE, OH","NORFOLK INTERNATION, VA",2023-07-07,5,5,0
3630199615,"CEDAR RAPIDS, IA","SPARTANBURG, SC",2023-07-07,-1,1,2
1087556197,"RUTHERFORD, PA","ATLANTA, GA",2023-07-07,9,8,-1
3630084624,"RUBY, GA","JACKSONVILLE, FL",2023-07-07,7,4,-3
3630191837,"SPARTA JCT, NJ","NEW ORLEANS, LA",2023-07-07,7,6,-1
1087634783,"SHARONVILLE, OH","SHARONVILLE, OH",2023-07-07,2,4,2
1087652707,"LAFAYETTE, IN","TWINSBURG, OH",2023-07-07,2,5,3
1087657197,"DES MOINES, IA","DES MOINES, IA",2023-07-07,4,1,-3
1087539551,"MONROE, MI","CHICAGO, IL",2023-07-07,10,9,-1
3630059310,"CLEVELAND, OH","MIDWEST PORTAGE, IN",2023-07-07,3,5,2
3630126905,"DILLEY, TX","PICAYUNE, MS",2023-07-07,7,8,1
3630072318,"LAGRANGE, NL","STERLING HEIGHTS, MI",2023-07-07,6,3,-3
1087576341,"WADSWORTH, TX","ADEL, GA",2023-07-07,4,7,3
3630068733,"LOS ANGELES, CA","RUTHERFORD, PA",2023-07-07,7,7,0
1087669542,"CHICAGO ENGLEW TV, IL","MECHANICVILLE, NY",2023-07-07,9,6,-3
3630122367,"DES MOINES, IA","DES MOINES, IA",2023-07-07,-2,1,3
3630207670,"ROBERTS BANK, BC","COLUMBUS, OH",2023-07-07,5,2,-3
3630123884,"LYONS, PA","CITY OF INDUSTRY, CA",2023-07-07,8,7,-1
3630073314,"CLINTON, IA","LOUISVILLE, KY",2023-07-07,8,7,-1
3630135865,"BOWDEN YARD, FL","CHICAGO 47TH ST TV, IL",2023-07-07,7,7,0
3630138813,"SERGEANT BLUFF, IA","SCHOOLCRAFT, MI",2023-07-06,2,2,0
3629775717,"LAMBERTS POINT, VA","TOMS CREEK, VA",2023-07-07,4,5,1
3630154770,"NORTH CHARLESTON, SC","DE RIDDER, LA",2023-07-07,11,10,-1
3630109636,"LOUISVILLE, KY","LOUISVILLE, KY",2023-07-03,-1,1,2
3628888818,"WINSTON-SALEM, NC","WHITE PIGEON, MI",2023-07-07,11,10,-1
1087649819,"FARRELL, PA","PAULSBORO, NJ",2023-07-07,2,4,2
1087625459,"CLEVELAND, OH","NORFOLK INTERNATION, VA",2023-07-07,4,7,3
1087633787,"SHARONVILLE, OH","SHARONVILLE, OH",2023-07-07,10,7,-3
1087564409,"CALVERT CITY, KY","EMORY GAP, TN",2023-07-07,8,8,0
3630078754,"CLEVELAND, TN","BROWNS, IL",2023-07-07,7,5,-2
3630188347,"TACOMA EXPORT, WA","CINCINNATI, OH",2023-07-07,5,5,0
3630074116,"SAVANNAH, GA","SAVANNAH, GA",2023-07-07,4,4,0
3630074221,"CITY OF INDUSTRY, CA","NORFOLK, VA",2023-07-06,8,10,2
3629741247,"LAMBERTS POINT, VA","TOMS CREEK, VA",2023-07-07,6,8,2
3630219596,"FINDERNE, NJ","LONGVIEW, TX",2023-07-07,10,10,0
3630168818,"MIAMI, FL","CINCINNATI, OH",2023-07-07,3,3,0
3630109505,"RED DEER, AB","LEWISTOWN (JVRR), PA",2023-07-07,12,10,-2
1087708320,"WINSTON-SALEM, NC","HOBBS, IN",2023-07-07,10,9,-1
3630205539,"CHOCOLATE BAYOU, TX","LINCOLN, AL",2023-07-07,4,1,-3
1087664754,"CHARLOTTE, NC","CHICAGO, IL",2023-07-07,6,5,-1
3630054679,"CAROL, IN","FRANCISCO, IN",2023-07-07,1,4,3
3630075641,"CAMPBELL ROAD YARD, OH","VON WILLER (CCRL), OH",2023-07-07,5,8,3
1087692171,"BOYKINS, VA","HUBBARD, OH",2023-07-07,5,7,2
1087587708,"MERIDIAN, MS","MERIDIAN, MS",2023-07-07,1,2,1
3630175205,"CITY OF INDUSTRY, CA","AYER, MA",2023-07-07,2,3,1
1087678004,"BETHINTERMODAL, PA","CHICAGO 47TH ST TV, IL",2023-07-07,4,1,-3
3630097164,"GREENVILLE, SC","GEISMAR, LA",2023-07-07,7,10,3
3630102155,"LOS ANGELES, CA","CROXTON, NJ",2023-07-07,1,2,1
1087529857,"ST LOUIS, MO","ST LOUIS, MO",2023-07-07,2,5,3
1087645166,"LUDLOWVILLE (ITHR), NY","SHELBURNE, VT",2023-07-07,7,4,-3
3630188339,"TACOMA EXPORT, WA","COLUMBUS, OH",2023-07-07,5,2,-3
1087579810,"ERIE, PA","ALEXANDRIA, VA",2023-07-07,8,7,-1
1087614076,"ROANOKE, VA","SOUTH RALEIGH, NC",2023-07-07,12,9,-3
3630196358,"TITUSVILLE, FL","SAN BERNARDINO, CA",2023-07-07,3,5,2
3630160404,"COLUMBUS, OH","KNOXVILLE, TN",2023-07-07,12,9,-3
3630081854,"BUTLER, IN","EAST CHICAGO, IN",2023-07-07,5,2,-3
3630107228,"SANDUSKY DOCK, OH","CROOKED CREEK MINE, PA",2023-07-07,7,8,1
3630075837,"LOS ANGELES, CA","BALTIMORE, MD",2023-07-07,3,6,3
3630058348,"NEAL, WV","SOUTH BEAMER, AB",2023-07-07,6,9,3
1087685970,"KINGSPORT, TN","LONGVIEW, TX",2023-07-07,10,9,-1
1087582994,"CROXTON, NJ","CHICAGO 47TH ST TV, IL",2023-07-07,8,6,-2
3630069242,"TACOMA BLAIR, WA","COLUMBUS, OH",2023-07-07,4,5,1
3630080939,"HYCO, NC","BAILEY MINE, PA",2023-07-06,8,5,-3
3629821314,"SURRENCY, GA","ANDERSON (ICRK), IN",2023-07-07,4,4,0
3630067965,"CHARLOTTE INTER, NC","CHARLOTTE INTER, NC",2023-07-07,-1,1,2
3630175734,"DAYTON, TX","MORRISTOWN, TN",2023-07-07,11,9,-2
3630055950,"MERIDIAN, MS","CHARLOTTE, NC",2023-07-07,10,8,-2
3630098819,"ASHEVILLE, NC","ENGLEHART, ON",2023-07-07,8,9,1
3630135807,"BOWDEN YARD, FL","ROSSVILLE, TN",2023-07-07,8,5,-3
3630138790,"SERGEANT BLUFF, IA","SCHOOLCRAFT, MI",2023-07-07,5,5,0
3630219033,"DUFFS JCT (POHC), PA","NARLO, OH",2023-07-07,0,1,1
3630172998,"DETROIT DEARBORN, MI","BIRMINGHAM, MO",2023-07-07,3,6,3
1087656997,"LORENZO, IL","NEW ORLEANS, LA",2023-07-07,5,4,-1
1087610909,"CHARLOTTE, NC","WYLIE, TX",2023-07-07,8,7,-1
3630090243,"MEMPHIS JCT, KY","NIXON, GA",2023-07-07,7,10,3
3630113481,"BOND HILL, OH","PRENTISS, AB",2023-07-07,4,5,1
3630218778,"ZEHNERS, PA","AUGUSTA, GA",2023-07-07,9,10,1
3630180195,"SHENANDOAH, PA","CLOVER BAR, AB",2023-07-07,10,8,-2
3630136764,"MEADVILLE, PA","CRYSTAL, ND",2023-07-07,2,2,0
3630093550,"WADSWORTH, TX","BESSEMER CITY, NC",2023-07-07,0,3,3
1087574250,"WAYNESBURG, PA","BETHLEHEM, PA",2023-07-07,2,3,1
3630203008,"LAMBERTS POINT, VA","TOMS CREEK, VA",2023-07-07,3,4,1
3630141010,"MIAMI, FL","CHICAGO 47TH ST TV, IL",2023-07-07,0,1,1
3630146840,"EAST ST LOUIS, IL","BLUFFTON, IN",2023-07-07,5,7,2
3630166939,"BRILLS, NJ","NEW LEXINGTON (OSRR, OH",2023-07-07,12,10,-2
3630142090,"OAKLAND, NJ","PORT WENTWORTH, GA",2023-07-07,9,10,1
3630136659,"LOGISTICS PARK CHIC, IL","CHICAGO, IL",2023-07-07,8,5,-3
1087533783,"DETROIT DEARBORN, MI","BIRMINGHAM, MO",2023-07-07,0,2,2
3630111138,"SARNIA, ON","WASHINGTON (DD), NJ",2023-07-07,6,8,2
3630212293,"MILLSDALE, IL","CAMP HILL, PA",2023-07-07,3,6,3
3630107600,"SANDUSKY DOCK, OH","CROOKED CREEK MINE, PA",2023-07-07,6,9,3
1087527368,"MERIDIAN, MS","CHARLOTTE, NC",2023-07-07,10,9,-1
1087520243,"VOLTZ, MO","GCT BAYONNE, NJ",2023-07-07,11,10,-1
3630099522,"THOMASVILLE, PA","BENTONITE, WY",2023-07-07,5,3,-2
3630219677,"EAGLE GROVE, IA","STATESVILLE, NC",2023-07-07,1,3,2
3630172883,"MARCUS, IA","ATLANTA, GA",2023-07-07,3,3,0
3630084836,"MEHOOPANY, PA","PHILADELPHIA, PA",2023-07-06,6,4,-2
1087262756,"LAMBERTS POINT, VA","TOMS CREEK, VA",2023-07-07,5,5,0
3630133342,"SELKIRK, NY","BUFFALO, NY",2023-07-07,4,2,-2
3630102066,"HOUSTON, TX","NEWELL, WV",2023-07-07,5,6,1
1087616109,"BURNS HARBOR, IN","BURNS HARBOR, IN",2023-07-07,4,1,-3
1087650438,"MECHANICVILLE, NY","COMMERCE, GA",2023-07-07,6,6,0
1087683669,"CHICAGO, IL","CROXTON, NJ",2023-07-07,10,7,-3
3630200254,"VOLTZ MIX CTR, MO","WALKERTOWN, NC",2023-07-07,9,6,-3
3630094019,"MEMPHIS, TN","JACKSONVILLE, FL",2023-07-07,2,3,1
1087626390,"SERGEANT BLUFF, IA","SCHOOLCRAFT, MI",2023-07-07,7,8,1
3630161832,"LAMBERTS POINT, VA","WILLIAMSON YARD, WV",2023-07-02,6,4,-2
3628757114,"CAROL, IN","FRANCISCO, IN",2023-06-28,7,7,0
1084444838,"SANDUSKY DOCK, OH","CROOKED CREEK MINE, PA",2023-07-07,2,3,1
3630195768,"BOYKINS, VA","HUBBARD, OH",2023-07-07,9,9,0
3630185810,"WYLIE, TX","JACKSONVILLE, FL",2023-07-07,1,4,3
1087663897,"BECANCOUR, PQ","DETROIT, MI",2023-07-07,12,10,-2
1087716365,"FINDERNE, NJ","LONGVIEW, TX",2023-07-07,0,3,3
1087682558,"TITUSVILLE, FL","SAN BERNARDINO, CA",2023-07-07,1,3,2
3630066375,"SELMA, AL","INDIANAPOLIS, IN",2023-07-07,9,7,-2
1087672579,"DALLAS, TX","CROXTON, NJ",2023-07-07,4,6,2
3630198017,"DECATUR, AL","PALMER, MS",2023-07-02,5,4,-1
3628755829,"CAROL, IN","FRANCISCO, IN",2023-07-07,6,5,-1
3630189686,"COLUMBIA CITY, IN","ST LOUIS, MO",2023-07-07,11,10,-1
3630157914,"BURNS HARBOR, IN","BURNS HARBOR, IN",2023-06-28,0,1,1
1084504808,"SANDUSKY DOCK, OH","CROOKED CREEK MINE, PA",2023-07-07,1,3,2
1087651036,"COLUMBUS, OH","KNOXVILLE, TN",2023-07-07,3,4,1
1087683790,"LITTLETON, MA","DECATUR, AL",2023-07-07,2,1,-1
1087635789,"EAST MODESTO, CA","HANNIBAL, MO",2023-07-07,5,7,2
1087633541,"LEVANCE SPUR, MO","BOYCE, TN",2023-07-07,6,3,-3
1087560772,"HYCO, NC","BAILEY MINE, PA",2023-07-07,0,3,3
1087715026,"CALVERT, AL","WATSON, CA",2023-07-07,0,1,1
3630108355,"VALDOSTA, GA","BURNSVILLE, MS",2023-07-07,4,6,2
3630112396,"RED DEER, AB","HAWTHORNE, NJ",2023-07-07,9,8,-1
3630096859,"BATH, PA","YOUNGSTOWN (YB), OH",2023-07-04,3,1,-2
1086412536,"SANDUSKY DOCK, OH","CROOKED CREEK MINE, PA",2023-07-07,0,1,1
3630064543,"MERIDIAN, MS","CHARLOTTE, NC",2023-07-07,-2,1,3
3630075667,"CAMPBELL ROAD YARD, OH","TOLEDO, OH",2023-07-07,1,3,2
1087660530,"CHICAGO 47TH ST TV, IL","HARRISBURG, PA",2023-07-07,10,7,-3
1087566354,"MEMPHIS, TN","MALLARD, AL",2023-07-07,4,2,-2
3630142684,"WEST LAKE, LA","REYBOLD, DE",2023-07-07,5,2,-3
3630171992,"CITY OF INDUSTRY, CA","AYER, MA",2023-07-07,7,6,-1
1087638737,"DECATUR, IL","HOMER, IL",2023-07-07,3,1,-2
1087576561,"JACKSON, MI","REDCO, ND",2023-07-07,0,2,2
3630134607,"ELKHART, IN","PINE, IN",2023-07-07,9,10,1
3630052499,"BLUFFTON, IN","SELMA, NC",2023-07-07,12,10,-2
3630154445,"BENTONITE, WY","YORK, PA",2023-07-07,4,4,0
3630187927,"MIAMI, FL","JACKSONVILLE, FL",2023-07-07,7,4,-3
3630110001,"LOUISVILLE, KY","LOUISVILLE, KY",2023-07-07,0,2,2
3630080303,"HYCO, NC","BAILEY MINE, PA",2023-07-07,7,7,0
1087607817,"FREMONT, OH","KRANNERT, GA",2023-07-07,4,4,0
1087589027,"ROGERSLACY, MS","NAMPA, AB",2023-07-07,1,4,3
3630099124,"ROSEPORT, MN","HOPEWELL, VA",2023-07-07,7,6,-1
3630075714,"CAMPBELL ROAD YARD, OH","VON WILLER (CCRL), OH",2023-07-07,4,7,3
3630116196,"NEW ORLEANS, LA","TYNER, TN",2023-07-07,2,2,0
3630088254,"ST LUC, PQ","GASTONIA, NC",2023-07-07,0,3,3
3630107406,"SANDUSKY DOCK, OH","CROOKED CREEK MINE, PA",2023-07-07,7,7,0
3630080858,"HYCO, NC","BAILEY MINE, PA",2023-07-07,-1,1,2
1087631256,"LAMBERTS POINT, VA","WILLIAMSON YARD, WV",2023-07-07,5,2,-3
1087655056,"CHARLESTON, TN","TENNILLE, GA",2023-07-07,5,3,-2
3630216572,"KENOVA, WV","WEST HAZLETON, PA",2023-07-07,11,9,-2
3630178596,"BUCKEYE, AZ","LAFAYETTE, IN",2023-07-07,6,3,-3
3630212617,"WINSTON-SALEM, NC","HOBBS, IN",2023-07-07,6,5,-1
3630174445,"CHATTANOOGA, TN","CHATTANOOGA, TN",2023-07-07,6,9,3
3630048458,"CICERO, IL","COLUMBUS, OH",2023-07-07,7,5,-2
3630208016,"WYLIE, TX","CHARLOTTE, NC",2023-07-07,12,10,-2
3630113601,"WYLIE, TX","ATLANTA, GA",2023-07-02,5,5,0
3628671740,"CHARLOTTE, NC","WHITE PIGEON, MI",2023-07-07,7,5,-2
1087547805,"LOS ANGELES, CA","BALTIMORE, MD",2023-07-07,8,9,1
3630183826,"NORFOLK INTERNATION, VA","LANDERS, IL",2023-07-07,5,7,2
1087666984,"ICTF, CA","GEORGETOWN, KY",2023-07-07,10,10,0
3630051702,"LAMBERTS POINT, VA","WILLIAMSON YARD, WV",2023-07-07,9,6,-3
3630065997,"CHICAGO, IL","CHICAGO, IL",2023-07-07,12,10,-2
1087587481,"BALTIMORE, MD","FEEDER, ON",2023-07-07,3,1,-2
1087635624,"LOUISVILLE, KY","JONES MILLS, AR",2023-07-07,4,5,1
3630086896,"KANSAS CITY, MO","MELVINDALE, MI",2023-07-07,4,1,-3
3630155344,"GREER, SC","CHARLESTON, SC",2023-07-07,7,8,1
3630111772,"NEWBERRY, PA","WYEVILLE, WI",2023-07-07,11,8,-3
1087649827,"LOS ANGELES, CA","MIAMI, FL",2023-07-07,7,9,2
1087543762,"RUBY, GA","JACKSONVILLE, FL",2023-07-07,10,8,-2
3630095162,"GATEWAY MINE, IL","WHEATFIELD, IN",2023-07-07,4,5,1
1087548869,"CANTON, OH","DYER, PA",2023-07-07,4,2,-2
1087695129,"PRESA DE LA CEBADA, GJ","LEIPSIC, OH",2023-07-07,4,4,0
3630132697,"LAMBERTS POINT, VA","WILLIAMSON YARD, WV",2023-07-07,8,9,1
1087684932,"WOODSTOCK, AL","TUSCALOOSA, AL",2023-07-07,5,3,-2
3630170302,"LAMBERTS POINT, VA","WILLIAMSON YARD, WV",2023-07-07,4,2,-2
3630057821,"JACKSONVILLE, FL","CHATTANOOGA, TN",2023-07-07,8,8,0
1087672537,"ATLANTA, GA","RUTHERFORD, PA",2023-07-07,10,9,-1
1087702374,"SCHENECTADY, NY","TAYLOR, PA",2023-07-07,4,7,3
3630175467,"COLUMBUS (CUOH), OH","CLEVELAND, OH",2023-07-07,4,5,1
1087599640,"RED DEER, AB","LOUISVILLE, KY",2023-07-07,6,3,-3
1087672074,"PORT ARTHUR, TX","ELIZABETH, NJ",2023-07-07,9,9,0
1087542871,"CHICAGO, IL","HARRISBURG, PA",2023-07-07,4,6,2
3630203260,"LAMBERTS POINT, VA","TOMS CREEK, VA",2023-07-07,5,4,-1
1087549784,"HARRISBURG, PA","CHICAGO 47TH ST TV, IL",2023-07-07,0,2,2
1087602134,"SHARONVILLE, OH","PORTSMOUTH APMT, VA",2023-07-07,3,3,0
3630187040,"PELHAM, GA","NORTH MANCHESTER, IN",2023-07-07,4,4,0
3630065549,"DECATUR, IL","CAREY, OH",2023-07-07,2,5,3
3630142147,"THOMASTON, IN","MONROE, MI",2023-07-07,5,2,-3
3630065565,"MONROE, MI","CHICAGO, IL",2023-07-07,8,6,-2
3630170815,"LAFAYETTE, IN","DISCOVERY PARK, OH",2023-07-07,8,9,1
1087536773,"AUSTELL, GA","CHICAGO, IL",2023-07-07,8,7,-1
3630163575,"MERIDIAN, MS","JACKSONVILLE, FL",2023-07-07,-1,2,3
3630156120,"DALLAS, TX","BETHINTERMODAL, PA",2023-07-07,2,3,1
1087628766,"ATLANTA, GA","TITUSVILLE, FL",2023-07-07,4,1,-3
1087671206,"GEISMAR, LA","MIDLAND, NC",2023-07-07,10,8,-2
3630146565,"PRATTVILLE, AL","BARRINGTON, NJ",2023-07-07,1,2,1
3630104173,"VENICE, IL","CARLISLE, PA",2023-07-07,0,1,1
3630122896,"MERIDIAN, MS","AUSTELL, GA",2023-07-07,10,9,-1
1087632757,"BAYARD, FL","MODESTO, CA",2023-07-07,7,6,-1
1087629526,"KANSAS CITY, MO","MELVINDALE, MI",2023-07-07,8,5,-3
3630108973,"LAKEVILLE, NY","KEOKUK, IA",2023-07-07,9,9,0
1087667689,"TIPTON, IN","BOGALUSA, LA",2023-07-07,13,10,-3
1087603693,"FARMERS VALLEY, PA","HOUSTON, TX",2023-07-07,5,5,0
1087535507,"LAMBERTS POINT, VA","WILLIAMSON YARD, WV",2023-07-07,4,5,1
3630147781,"DECATUR, IL","DECATUR, IL",2023-07-07,4,1,-3
3630085214,"CASTLE HAYNE, NC","NORFOLK, VA",2023-07-07,13,10,-3
1087606243,"TOLEDO, OH","MIDDLETOWN, OH",2023-07-07,10,8,-2
3630108313,"VALDOSTA, GA","BURNSVILLE, MS",2023-07-07,5,5,0
3630171489,"YOUNGSTOWN, OH","NORTH BERGEN, NJ",2023-07-07,3,4,1
3630136667,"LOGISTICS PARK CHIC, IL","CHICAGO, IL",2023-07-07,3,3,0
3630114110,"MIAMI, FL","ATLANTA, GA",2023-07-07,10,8,-2
3630146549,"PRATTVILLE, AL","LEXINGTON, SC",2023-07-07,7,7,0
3630125789,"LOS ANGELES, CA","CROXTON, NJ",2023-07-07,7,7,0
3630100129,"INWOOD, WV","WARREN, PA",2023-07-07,6,6,0
3630158805,"BURNS HARBOR, IN","BURNS HARBOR, IN",2023-07-07,-1,2,3
3630212748,"WINSTON-SALEM, NC","HOBBS, IN",2023-07-07,-2,1,3
3630077952,"BUFFALO, NY","LIMA, OH",2023-07-07,2,2,0
3630194542,"LUFKIN, TX","HILL, AL",2023-07-07,4,5,1
1087634791,"SHARONVILLE, OH","SHARONVILLE, OH",2023-07-07,10,9,-1
3630157841,"BURNS HARBOR, IN","BURNS HARBOR, IN",2023-07-06,13,10,-3
1087043869,"LAMBERTS POINT, VA","TOMS CREEK, VA",2023-07-07,3,2,-1
1087577355,"GATEWAY MINE, IL","WHEATFIELD, IN",2023-07-07,8,6,-2
1087604762,"CHICAGO, IL","HARRISBURG, PA",2023-07-07,11,9,-2
3630216459,"STOCKTON IMF, CA","JACKSONVILLE, FL",2023-07-07,7,4,-3
3630119437,"BEAUHARNOIS, PQ","KERNERSVILLE, NC",2023-06-28,11,8,-3
1084538140,"SANDUSKY DOCK, OH","CROOKED CREEK MINE, PA",2023-07-07,0,3,3
3630194720,"FARMERS VALLEY, PA","WOODS CROSS, UT",2023-07-07,5,8,3
1087670187,"MELVINDALE, MI","KANSAS CITY, MO",2023-07-07,5,4,-1
1087692668,"DECATUR, AL","WYTHEVILLE, VA",2023-07-07,10,7,-3
3630078039,"LOS ANGELES, CA","MORRISVILLE, PA",2023-07-07,1,1,0
3630103850,"HICKS, TX","CALVERT, AL",2023-07-07,4,5,1
1087670624,"CARROLL, TN","LEEDS, AL",2023-07-07,2,1,-1
3630177972,"WAYCROSS, GA","JACKSONVILLE, FL",2023-07-07,10,9,-1
3630197053,"ALBERT LEA, MN","INWOOD, WV",2023-07-07,6,7,1
3630169759,"HOLLIDAYSBURG, PA","NATRIUM, WV",2023-07-07,5,6,1
3630108753,"CLYMERS, IN","CLYMERS, IN",2023-07-07,6,4,-2
1087522261,"LAMBERTS POINT, VA","WILLIAMSON YARD, WV",2023-07-07,11,9,-2
3630171316,"WOODSTOCK, ON","WESTLAKE, FL",2023-07-07,6,7,1
1087670991,"WAYCROSS, GA","JACKSONVILLE, FL",2023-07-07,4,5,1
3630099849,"CHARLESTON, SC","CHARLOTTE, NC",2023-07-07,9,6,-3
3630199720,"CEDAR RAPIDS, IA","CITY POINT, FL",2023-07-07,2,2,0
3630142066,"LOGISTICS PARK CHIC, IL","CHICAGO, IL",2023-07-07,5,5,0
1087538822,"MIDDLETOWN, OH","CALVERT, AL",2023-07-07,7,8,1
1087581061,"CROXTON, NJ","CHICAGO 47TH ST TV, IL",2023-07-07,4,1,-3
3630062478,"BARSTOW, CA","CROXTON, NJ",2023-07-07,4,3,-1
3630063050,"CLARE, OH","GRAND FORKS, ND",2023-07-07,4,1,-3
3630058314,"BAYPORT, TX","CELCO, VA",2023-07-06,10,7,-3
1087517208,"DECATUR, IL","DECATUR, IL",2023-07-07,7,4,-3
3630081341,"RUBY, GA","JACKSONVILLE, FL",2023-07-07,6,6,0
3630156900,"BURLEY, ID","LEXINGTON, SC",2023-07-07,5,6,1
1087548819,"CANTON, OH","DYER, PA",2023-07-07,12,9,-3
3630127456,"TOLEDO, OH","INDIANA HARBOR, IN",2023-07-07,8,7,-1
1087615501,"DARROW, IL","LAFAYETTE, IN",2023-07-07,7,4,-3
3630172524,"BELLEVUE, OH","BROADWAY, VA",2023-07-07,-1,1,2
3630172126,"BECANCOUR, PQ","DETROIT, MI",2023-07-07,2,3,1
3630189416,"BIRMINGHAM, MO","CHICAGO HEIGHTS, IL",2023-07-07,2,2,0
3630179924,"CLIFTON, NJ","FORMOSA, TX",2023-07-07,4,3,-1
3630108004,"SOUTH BAY CITY, TX","COLUMBUS, OH",2023-07-07,4,3,-1
3630136641,"LOGISTICS PARK CHIC, IL","CHICAGO, IL",2023-07-07,5,5,0
3630166882,"WEST HAZLETON, PA","WALDENBURG, AR",2023-07-07,9,7,-2
3630100014,"CLAY, DE","CENTRAL CITY, NE",2023-07-07,11,10,-1
3630148185,"DECATUR, IL","DECATUR, IL",2023-07-07,7,7,0
1087532680,"CALUMET, IL","CHARLOTTE, NC",2023-07-07,7,6,-1
3630074425,"EVANS CITY, PA","GASTONIA, NC",2023-07-07,2,2,0
3630085094,"CITY OF INDUSTRY, CA","PITTSBURGH, PA",2023-07-07,2,3,1
3630093982,"MEMPHIS, TN","JACKSONVILLE, FL",2023-07-07,2,2,0
1087695412,"NIXON, GA","DETROIT, MI",2023-07-07,6,5,-1
3630167244,"GARY, IN","MIDWEST PORTAGE, IN",2023-07-07,4,7,3
3630123787,"KINGSPORT, TN","ROSSER, GA",2023-07-07,2,3,1
1087644097,"PITTSFIELD, MA","KANKAKEE, IL",2023-07-07,5,2,-3
1087694408,"ROANOKE, IN","EAST BROOKFIELD, MA",2023-07-07,12,10,-2
3630098869,"ASHEVILLE, NC","NORANDA, PQ",2023-07-07,5,2,-3
3630183884,"NORFOLK INTERNATION, VA","LANDERS, IL",2023-07-07,5,7,2
1087680124,"WILLIAMSPORT, MD","WESTVACO, WY",2023-07-07,7,8,1
3630063678,"TOLEDO AIRLINE, OH","TOLEDO AIRLINE, OH",2023-07-07,4,5,1
3630134534,"WARREN, PA","INWOOD, WV",2023-07-07,8,5,-3
1087595183,"PRESCOTT, ON","TOLEDO, OH",2023-07-07,10,9,-1
3630068466,"CHICAGO, IL","COLUMBUS, OH",2023-07-07,9,9,0
3630056980,"GARYVILLE, LA","MIDLAND, NC",2023-07-07,1,4,3
3630163680,"MERIDIAN, MS","TITUSVILLE, FL",2023-07-07,5,5,0
3630118619,"ARLINGTON, WA","NEW HAVEN, IN",2023-07-07,4,6,2
3630211823,"WINSTON-SALEM, NC","HOBBS, IN",2023-07-07,6,6,0
1087686120,"MONROE, OH","GARY, IN",2023-07-07,10,9,-1
1087693923,"WESTVACO, WY","WILLIAMSPORT, MD",2023-07-07,5,6,1
3630111154,"SARNIA, ON","WASHINGTON (DD), NJ",2023-07-07,-2,1,3
1087580243,"MARTINS CREEK, PA","HARRINGTON, DE",2023-07-07,6,9,3
1087588712,"STRANG, TX","ARCHBALD, PA",2023-07-07,5,8,3
3630075887,"MERIDIAN, MS","CHARLOTTE, NC",2023-07-07,4,2,-2
1087670365,"DISCOVERY PARK, OH","NORFOLK INTERNATION, VA",2023-07-07,0,3,3
3630142236,"THOMASTON, IN","MONROE, MI",2023-07-07,13,10,-3
3630089624,"GREENVILLE, SC","DAYTON, TX",2023-07-07,4,3,-1
3630117176,"WALKERTOWN, NC","ROANOKE, IN",2023-07-02,1,1,0
3628751574,"LAMBERTS POINT, VA","TOMS CREEK, VA",2023-07-07,11,8,-3
3630114160,"NEW ORLEANS, LA","AKRON, OH",2023-07-07,9,9,0
1087555052,"MORRISVILLE TV, PA","CHICAGO ENGLEW TV, IL",2023-07-07,0,1,1
3630191332,"HOLLIDAYSBURG, PA","KOPPEL, PA",2023-07-07,7,5,-2
1087708508,"WINSTON-SALEM, NC","HOBBS, IN",2023-07-07,11,9,-2
3630109474,"LOUDON, TN","GEISMAR, LA",2023-07-07,7,4,-3
3630161989,"LACYMARK, FL","JUNCTION CITY, GA",2023-07-07,6,8,2
3630208472,"WESTLAKE, FL","GEORGETOWN, KY",2023-07-07,8,7,-1
3630171976,"KNOXVILLE, TN","LOUISVILLE, KY",2023-07-07,9,9,0
3630080882,"HYCO, NC","BAILEY MINE, PA",2023-07-07,3,3,0
1087645679,"BARNESVILLE, GA","JACKSONVILLE, FL",2023-07-07,5,3,-2
3630064399,"RICHMOND, VA","TROUTVILLE, VA",2023-07-07,7,4,-3
1087591626,"VALDOSTA, GA","MACON, GA",2023-07-07,11,8,-3
1087622419,"HUNTSVILLE, AL","GARDEN CITY, GA",2023-07-07,10,7,-3
1087606544,"MACMILLAN, AL","WINSTON-SALEM, NC",2023-07-07,3,3,0
3630077635,"SAN BERNARDINO, CA","JACKSONVILLE, FL",2023-07-07,9,9,0
3630162773,"LUDLOWVILLE (ITHR), NY","KNOXVILLE, TN",2023-07-07,5,3,-2
1087658313,"BRILLS, NJ","NEW LEXINGTON (OSRR, OH",2023-07-07,3,5,2
3630076396,"CITY OF INDUSTRY, CA","TOLEDO, OH",2023-07-07,5,2,-3
3630071956,"LAMBERTS POINT, VA","WILLIAMSON YARD, WV",2023-07-07,0,1,1
3630167278,"BRILLS, NJ","NEW LEXINGTON (OSRR, OH",2023-07-07,-1,1,2
1087524019,"BLUFFTON, IN","SELMA, NC",2023-07-07,11,9,-2
1087677993,"BETHINTERMODAL, PA","CHICAGO 47TH ST TV, IL",2023-07-07,3,6,3
3630182189,"SELKIRK, NY","LAFAYETTE, IN",2023-07-07,9,9,0
3630110069,"LOUISVILLE, KY","LOUISVILLE, KY",2023-07-07,11,9,-2
3630059336,"WYSOX, PA","WEDRON, IL",2023-07-07,6,7,1
3630147121,"BIGGAR, SK","WILKES BARRE, PA",2023-07-06,8,5,-3
3629873785,"LAMBERTS POINT, VA","TOMS CREEK, VA",2023-07-07,4,5,1
3630064802,"SAN BERNARDINO, CA","CHARLOTTE, NC",2023-07-07,6,9,3
3630155970,"CHICAGO, IL","CHICAGO MIX CTR, IL",2023-07-07,6,6,0
3630086854,"KANSAS CITY, MO","MELVINDALE, MI",2023-07-07,6,5,-1
3630052601,"BLUFFTON, IN","SELMA, NC",2023-07-07,6,8,2
3630174021,"KANSAS CITY, MO","PETERSBURG, VA",2023-07-07,5,4,-1
3630217918,"DECATUR, AL","STREATOR, IL",2023-07-07,7,9,2
3630134186,"DECATUR, IL","ROHRERSTOWN, PA",2023-07-07,1,2,1
1087540073,"LOS ANGELES, CA","JACKSONVILLE, FL",2023-07-07,7,5,-2
3630127040,"BURNS HARBOR, IN","BURNS HARBOR, IN",2023-07-07,1,4,3
3630121913,"HAMILTON, ON","MELVINDALE, MI",2023-07-02,-1,1,2
3628723246,"LAMBERTS POINT, VA","TOMS CREEK, VA",2023-07-07,2,3,1
3630157964,"BURNS HARBOR, IN","BURNS HARBOR, IN",2023-07-07,1,3,2
3630078348,"LOS ANGELES, CA","CROXTON, NJ",2023-07-07,7,4,-3
3630132532,"LAMBERTS POINT, VA","WILLIAMSON YARD, WV",2023-07-07,4,2,-2
1087634270,"APPLIANCE PARK, KY","PORTSMOUTH APMT, VA",2023-07-07,2,3,1
3630107676,"SANDUSKY DOCK, OH","CROOKED CREEK MINE, PA",2023-07-07,2,4,2
1087562148,"CALVERT, AL","INDIANA HARBOR, IN",2023-07-07,4,6,2
3630142707,"MOSS POINT, MS","NORFOLK, VA",2023-07-07,7,10,3
3630128737,"BURNS HARBOR, IN","BURNS HARBOR, IN",2023-07-07,7,5,-2
3630076419,"LOS ANGELES, CA","CROXTON, NJ",2023-07-07,7,8,1
3630098398,"CROXTON, NJ","CROXTON, NJ",2023-07-07,1,3,2
3630154673,"LUDLOWVILLE (ITHR), NY","SHELBURNE, VT",2023-07-07,0,3,3
3630122618,"HOUSTON, TX","PEDRICKTOWN, NJ",2023-07-07,5,8,3
3630123541,"READING, PA","WISCONSIN DAM, WI",2023-07-07,6,5,-1
3630092392,"WAYNESBURG, PA","BETHLEHEM, PA",2023-07-07,5,6,1
3630118813,"FARMERS VALLEY, PA","PHILA PORT RICHMOND, PA",2023-07-07,2,3,1
1087640823,"DECATUR, IL","FREMONT, OH",2023-07-07,0,1,1
3630163583,"MERIDIAN, MS","MIAMI, FL",2023-07-07,1,1,0
1087595280,"PINEVILLE, NC","CHICAGO, IL",2023-07-07,6,3,-3
3630181002,"CHICAGO, IL","LEXINGTON, KY",2023-07-07,5,6,1
3630185064,"PETERSBURG, VA","BUTLER, IA",2023-07-04,12,9,-3
3629134181,"SANDUSKY DOCK, OH","CROOKED CREEK MINE, PA",2023-07-07,8,9,1
1087594802,"COLUMBUS, OH","WA UNITED TRM (WUT), WA",2023-07-07,5,6,1
1087524718,"CHICAGO, IL","TOLEDO, OH",2023-07-07,6,3,-3
3630150629,"DECATUR, IL","SELMA, AL",2023-07-07,4,7,3
3630074962,"AMELIA, TX","AMHERST, VA",2023-07-07,13,10,-3
3630121002,"TOLEDO, OH","MIDDLETOWN, OH",2023-07-07,9,8,-1
3630085662,"HERSHEY, PA","DAYTON, OH",2023-07-07,6,4,-2
3630093241,"COLLIERVILLE, TN","BAYPORT, TX",2023-07-07,6,7,1
3630110857,"MIAMI, FL","CALUMET, IL",2023-07-07,9,8,-1
3630099815,"COVINGTON, VA","CHARLOTTE, NC",2023-07-07,6,8,2
1087618517,"OXFORD, NC","BUCHANAN, VA",2023-07-07,3,5,2
1087716438,"EAGLE GROVE, IA","STATESVILLE, NC",2023-07-07,2,4,2
3630123795,"OLD FORT, OH","BENTONITE, WY",2023-07-07,2,2,0
1087688805,"LAMBERTS POINT, VA","WILLIAMSON YARD, WV",2023-07-07,0,3,3
3630074750,"ST GABRIEL, LA","CHICKAMAUGA, GA",2023-07-07,7,5,-2
3630169694,"MUNCY (LVRR), PA","LORDSTOWN, OH",2023-07-07,6,7,1
1087593377,"CLEVELAND, OH","LONG BEACH E PIER, CA",2023-07-07,3,6,3
1087547766,"CHARLESTON, SC","CHARLOTTE, NC",2023-07-07,4,6,2
3630203189,"LAMBERTS POINT, VA","TOMS CREEK, VA",2023-07-07,7,9,2
3630052431,"BLUFFTON, IN","SELMA, NC",2023-07-07,8,9,1
1087653850,"AUSTELL, GA","LOS ANGELES, CA",2023-07-07,9,9,0
3630124644,"CHEROKEE, AL","TEXARKANA, TX",2023-07-07,5,6,1
1087522180,"CAROL, IN","FRANCISCO, IN",2023-07-07,8,5,-3
1087685946,"KINGSPORT, TN","MAGNESS, AR",2023-07-07,3,5,2
3630218396,"CALVERT, AL","NORTH CHATTANOOGA, TN",2023-07-07,4,4,0
3630215102,"STOCKTON IMF, CA","JACKSONVILLE, FL",2023-07-07,9,7,-2
3630097457,"GALLIPOLIS, WV","HAVERHILL, OH",2023-07-07,11,8,-3
3630142595,"DAVISVILLE, RI","LAFAYETTE, IN",2023-07-07,0,2,2
3630151900,"KEOKUK, IA","ALTOONA, PA",2023-07-07,2,4,2
3630173384,"LATHROP, CA","AUSTELL, GA",2023-07-02,4,6,2
3628671994,"CHARLOTTE, NC","WHITE PIGEON, MI",2023-07-07,11,8,-3
1087601489,"LAFAYETTE, IN","LAFAYETTE, IN",2023-07-07,2,4,2
1087545031,"BUFFALO, NY","CHICAGO, IL",2023-07-07,3,6,3
3630052279,"BLUFFTON, IN","SELMA, NC",2023-07-07,4,2,-2
1087545201,"HARRISBURG, PA","CHICAGO, IL",2023-07-07,8,5,-3
3630124791,"LOS ANGELES, CA","CHARLOTTE, NC",2023-07-07,1,3,2
3630051142,"CLEVEDALE, SC","CALVERT, AL",2023-07-07,4,7,3
1087595206,"MAHRT (CCH), AL","PORT WENTWORTH, GA",2023-07-07,4,3,-1
3630063555,"INTERPUERTO, SL","AUSTELL, GA",2023-07-07,6,5,-1
3630109092,"TERRE HAUTE, IN","BRACKENRIDGE, PA",2023-07-07,8,9,1
3630080646,"HYCO, NC","BAILEY MINE, PA",2023-07-07,11,10,-1
1087574527,"BARSTOW, CA","CROXTON, NJ",2023-07-07,4,1,-3
3630155572,"ICTF, CA","GEORGETOWN, KY",2023-07-07,-2,1,3
1087567643,"ST LOUIS, MO","PARACHUTE, CO",2023-07-07,11,9,-2
3630052148,"BLUFFTON, IN","SELMA, NC",2023-07-07,6,8,2
3630173009,"GEISMAR, LA","MIDLAND, NC",2023-07-07,1,3,2
3630209606,"BAYWAY, NJ","CHICAGO, IL",2023-07-07,9,10,1
3630072067,"CHAPMAN, PA","APPLE GROVE, WV",2023-07-07,6,6,0
1087647168,"CARROLL, TN","ROANOKE, VA",2023-07-07,9,9,0
3630080361,"HYCO, NC","BAILEY MINE, PA",2023-07-06,2,2,0
3629821429,"SURRENCY, GA","ANDERSON (ICRK), IN",2023-07-07,5,2,-3
3630126557,"BURNS HARBOR, IN","CLEVELAND, OH",2023-07-07,0,2,2
3630207989,"DES MOINES, IA","DES MOINES, IA",2023-07-07,0,3,3
1087521281,"CAROL, IN","FRANCISCO, IN",2023-07-07,0,1,1
3630099823,"CLAY, DE","THOMASTON, IN",2023-07-07,3,3,0
3630193318,"ST GABRIEL, LA","PINEVILLE, NC",2023-07-07,6,7,1
3630162480,"OTTAWA, IL","LONG RIDGE, OH",2023-07-07,6,3,-3
3630148745,"WINFIELD, PA","MADISON, MN",2023-07-07,2,2,0
3630134356,"ANNISTON, AL","CHOCOLATE BAYOU, TX",2023-06-28,5,7,2
1084550566,"SANDUSKY DOCK, OH","CROOKED CREEK MINE, PA",2023-07-06,9,9,0
3629741823,"LAMBERTS POINT, VA","TOMS CREEK, VA",2023-07-07,10,8,-2
1087587237,"OLD OCEAN, TX","PINEVILLE, NC",2023-07-07,11,8,-3
3630065036,"MONROE, MI","THUNDER JCT WEST, WY",2023-07-07,1,2,1
3630133059,"SELKIRK, NY","BUFFALO, NY",2023-07-07,-1,1,2
3630115807,"RICHLAND, WA","MCDONOUGH, GA",2023-07-07,9,10,1
3630048571,"CICERO, IL","CROXTON, NJ",2023-07-07,7,7,0
3630076037,"MERIDIAN, MS","CHARLOTTE, NC",2023-07-07,4,5,1
1087566401,"SAVANNAH, GA","CLYATTVILLE, GA",2023-07-07,8,6,-2
3630205393,"LOS ANGELES, CA","AUSTELL, GA",2023-07-07,4,1,-3
3630141515,"ASHEVILLE, NC","GIANT, SC",2023-07-07,3,1,-2
3630098403,"GENEVA, NY","CORNING, NY",2023-07-07,3,1,-2
3630174453,"COLLEGE PARK, GA","NORTH CHATTANOOGA, TN",2023-07-07,7,4,-3
3630194665,"SANDERSVILLE, GA","WABASH, IN",2023-07-07,9,9,0
3630175726,"DAYTON, TX","MANVILLE, NJ",2023-07-07,2,1,-1
3630132029,"NIAGARA FALLS, NY","PERRYMAN, MD",2023-07-07,6,3,-3
3630146921,"CHICAGO HEIGHTS, IL","BIRMINGHAM, MO",2023-07-07,9,10,1
3630065010,"MONROE, MI","THUNDER JCT WEST, WY",2023-07-07,13,10,-3
1087679351,"GARY, IN","MIDWEST PORTAGE, IN",2023-07-07,6,8,2
3630202874,"LAMBERTS POINT, VA","TOMS CREEK, VA",2023-07-07,8,9,1
3630211695,"WINSTON-SALEM, NC","HOBBS, IN",2023-07-07,3,2,-1
3630072855,"SAN BERNARDINO, CA","CHARLOTTE, NC",2023-07-07,6,3,-3
3630088288,"BOWDEN YARD, FL","BARIN, GA",2023-07-07,7,5,-2
1087660831,"ZORRA, ON","SIEGFRIED, PA",2023-07-07,10,10,0
1087565049,"CALVERT, AL","INDIANA HARBOR, IN",2023-07-07,4,6,2
3630134623,"CHALCO, NE","BURNS HARBOR, IN",2023-07-07,-2,1,3
3630198279,"COLUMBUS, NE","MORRISVILLE, PA",2023-07-07,-1,1,2
3630062135,"BELLEVUE, OH","BELLEVUE, OH",2023-07-07,10,9,-1
3630112207,"PRESCOTT, ON","TOLEDO, OH",2023-07-07,0,1,1
1087715220,"KENOVA, WV","MOCKSVILLE, NC",2023-07-07,10,9,-1
3630178083,"HOUSTON, TX","SIEGFRIED, PA",2023-07-07,7,4,-3
3630175077,"AUGUSTA, GA","LULING, LA",2023-07-06,3,5,2
3630015984,"LAMBERTS POINT, VA","TOMS CREEK, VA",2023-07-07,-2,1,3
1087562910,"GARDEN CITY, GA","NEW ORLEANS, LA",2023-07-02,3,2,-1
3628723408,"LAMBERTS POINT, VA","TOMS CREEK, VA",2023-07-07,6,3,-3
1087547384,"AUSTELL INTERMODAL, GA","GARDEN CITY, GA",2023-07-07,8,10,2
3630051469,"LAMBERTS POINT, VA","WILLIAMSON YARD, WV",2023-07-07,10,8,-2
3630197998,"NORTH BIRMINGHAM, AL","SPOCARI, AL",2023-07-07,6,4,-2
3630192257,"REEDSBURG, WI","SELMA, NC",2023-07-07,2,5,3
1087611793,"AUSTELL, GA","GARDEN CITY, GA",2023-07-07,7,8,1
3630205678,"CHOCOLATE BAYOU, TX","LEIPSIC, OH",2023-07-07,7,9,2
1087617040,"CHICAGO, IL","JACKSONVILLE, FL",2023-07-07,8,5,-3
1087635187,"ELDON, TX","MONTGOMERY, NY",2023-07-07,10,8,-2
1087646609,"ARKANSAS CITY, KS","CAMP HILL, PA",2023-07-07,4,4,0
3630161361,"LAMBERTS POINT, VA","WILLIAMSON YARD, WV",2023-07-07,-2,1,3
3630092897,"RINCON, GA","BROOKLAWN, LA",2023-07-07,1,2,1
3630198562,"PRESA DE LA CEBADA, GJ","LEIPSIC, OH",2023-07-07,7,8,1
3630146345,"SUTTON, FL","CHARLESTON, TN",2023-07-07,8,9,1
3630077821,"ST PAUL, MN","HARRISBURG, PA",2023-07-07,11,10,-1
1087618054,"SAVANNAH, GA","GARDEN CITY, GA",2023-07-07,1,3,2
3630097279,"SAN BERNARDINO, CA","CHARLOTTE, NC",2023-07-07,7,6,-1
3630185975,"GEORGETOWN, KY","ST JOHNS, OR",2023-07-07,6,9,3
3630211815,"WINSTON-SALEM, NC","HOBBS, IN",2023-07-07,10,10,0
1087593490,"CHICAGO ENGLEW TV, IL","CICERO, IL",2023-07-07,2,4,2
3630096914,"NORCO, LA","BALTIMORE, MD",2023-07-07,4,7,3
3630152134,"KEOKUK, IA","ALTOONA, PA",2023-07-07,12,9,-3
3630136879,"MUNCY (LVRR), PA","LORDSTOWN, OH",2023-07-07,5,3,-2
3630213582,"PRINCE GEORGE, BC","ROYSTON, GA",2023-07-07,1,4,3
3630114453,"LOS ANGELES, CA","JACKSONVILLE, FL",2023-07-06,12,10,-2
1087312658,"LAMBERTS POINT, VA","TOMS CREEK, VA",2023-07-07,2,4,2
3630190491,"WILMINGTON, CA","PORT NEWARK ELIZABE, NJ",2023-07-07,0,1,1
3630151992,"EAST ST LOUIS, IL","BLUFFTON, IN",2023-07-07,0,3,3
3630109076,"TERRE HAUTE, IN","FARRELL, PA",2023-07-07,2,2,0
3630116528,"GARY, IN","DEARBORN, MI",2023-07-07,11,8,-3
3630126688,"DILLEY, TX","PICAYUNE, MS",2023-07-07,4,2,-2
1087577779,"GATEWAY MINE, IL","WHEATFIELD, IN",2023-07-07,7,6,-1
3630102090,"HOUSTON, TX","MASON, OH",2023-07-07,6,8,2
1087543908,"CHARLOTTE INTER, NC","SAN BERNARDINO, CA",2023-07-07,5,7,2
3630052017,"BLUFFTON, IN","SELMA, NC",2023-07-07,6,5,-1
3630096817,"BATH, PA","YOUNGSTOWN (YB), OH",2023-07-07,6,3,-3
1087637040,"WEST ELIZABETH, PA","SHIRE OAKS, PA",2023-07-07,6,4,-2
3630052342,"BLUFFTON, IN","SELMA, NC",2023-07-07,8,9,1
3630154958,"TOLEDO, OH","LAUREL, MT",2023-07-07,11,8,-3
3630193889,"ST GABRIEL, LA","CHATTANOOGA, TN",2023-07-07,7,9,2
1087596375,"COLUMBUS, OH","TACOMA, WA",2023-07-07,5,4,-1
3630186816,"TACOMA EXPORT, WA","COLUMBUS, OH",2023-07-07,7,7,0
3630098152,"NORFOLK, VA","NORFOLK, VA",2023-07-07,7,5,-2
3630107252,"SANDUSKY DOCK, OH","CROOKED CREEK MINE, PA",2023-07-07,1,1,0
3630189555,"COLUMBIA CITY, IN","ST LOUIS, MO",2023-07-07,1,2,1
3630193295,"LAMBERTS POINT, VA","WILLIAMSON YARD, WV",2023-07-07,5,2,-3
3630142074,"COATESVILLE, PA","NORTH HOUSTON, TX",2023-07-07,4,5,1
3630100072,"CHICAGO, IL","BRUNSWICK, MO",2023-07-07,9,6,-3
3630219326,"MUNCY (LVRR), PA","BUTLER, PA",2023-07-07,5,5,0
3630208537,"DUBLIN, GA","OTTAWA LAKE, MI",2023-07-07,10,10,0
3630048709,"CICERO, IL","BETHINTERMODAL, PA",2023-07-07,6,4,-2
3630071087,"LOS ANGELES, CA","CROXTON, NJ",2023-07-07,10,8,-2
3630060654,"CHICAGO, IL","CINCINNATI, OH",2023-07-07,5,7,2
1087598898,"RUTHERFORD, PA","ST LOUIS, MO",2023-07-07,5,7,2
3630071388,"LAMBERTS POINT, VA","WILLIAMSON YARD, WV",2023-07-07,12,10,-2
3630218980,"DUFFS JCT (POHC), PA","NARLO, OH",2023-07-07,2,4,2
3630073225,"LOS ANGELES, CA","AUSTELL, GA",2023-07-07,6,5,-1
3630120925,"RIVER ROUGE, MI","NEWELL, WV",2023-07-07,4,6,2
3630088296,"ST LUC, PQ","GASTONIA, NC",2023-07-07,7,4,-3
1087597965,"LANDERS, IL","CLEVELAND, OH",2023-07-07,8,9,1
3630163591,"MERIDIAN, MS","RUTHERFORD, PA",2023-07-07,4,4,0
3630076087,"MERIDIAN, MS","JACKSONVILLE, FL",2023-07-07,7,10,3
3630093819,"MEMPHIS, TN","CHARLOTTE, NC",2023-07-07,4,4,0
1087619636,"SELKIRK, NY","BUFFALO, NY",2023-07-07,6,6,0
3630105488,"CLEVELAND, OH","BURNS HARBOR, IN",2023-07-07,9,7,-2
1087595735,"DUBLIN, GA","OTTAWA LAKE, MI",2023-07-07,-1,1,2
1087529718,"NEAL, WV","KENOVA, WV",2023-07-07,0,3,3
3630115441,"NORTH CHARLESTON, SC","COLUMBIA, SC",2023-07-07,-2,1,3
3630197304,"PORTLAND, OR","AYER, MA",2023-07-07,5,4,-1
1087554886,"MORRISVILLE TV, PA","CHICAGO ENGLEW TV, IL",2023-07-07,6,7,1
3630110742,"CHICAGO ENGLEW TV, IL","CHICAGO ENGLEW TV, IL",2023-07-07,11,9,-2
3630080989,"HYCO, NC","BAILEY MINE, PA",2023-07-07,6,6,0
3630210128,"MASON CITY, IA","CORDELE (HOG), GA",2023-07-07,5,5,0
1087517795,"PITTSBURGH, PA","HARRISBURG, PA",2023-07-07,4,1,-3
3630112778,"DUBLIN, GA","KINGSTON, OH",2023-07-07,-2,1,3
3630133067,"SELKIRK, NY","BUFFALO, NY",2023-07-07,2,1,-1
3630075497,"SAN BERNARDINO, CA","CHARLOTTE, NC",2023-07-07,12,10,-2
1087530840,"BELLEVUE, OH","BELLEVUE, OH",2023-07-07,8,8,0
1087652634,"LACYMARK, FL","JUNCTION CITY, GA",2023-07-07,8,5,-3
3630094158,"MEMPHIS, TN","JACKSONVILLE, FL",2023-07-07,5,7,2
3630188517,"TACOMA EXPORT, WA","CLEVELAND, OH",2023-07-07,7,7,0
3630219203,"KANSAS CITY, MO","BELLE (KNWA), WV",2023-07-07,7,10,3
3630211629,"MONTEVIDEO, MN","TAYLORSVILLE, NC",2023-07-07,4,2,-2
1087597397,"MIAMI, FL","ATLANTA, GA",2023-07-07,7,8,1
1087681659,"HUNTSVILLE, AL","HUNTSVILLE, AL",2023-07-07,5,5,0
3630068547,"CHICAGO, IL","COLUMBUS, OH",2023-07-07,-1,2,3
1087555751,"CHICAGO ENGLEW TV, IL","BALTIMORE, MD",2023-07-07,0,2,2
3630108559,"CONWAY, PA","CONVERSE JCT, WY",2023-07-07,-2,1,3
1087581574,"ASHEVILLE, NC","FAIRPORT HARBOR, OH",2023-07-02,5,7,2
3628756061,"CAROL, IN","FRANCISCO, IN",2023-07-07,10,10,0
1087600467,"RICHLAND, WA","MCDONOUGH, GA",2023-07-07,5,5,0
3630049577,"PORT WENTWORTH, GA","LUDLOW, KY",2023-07-07,5,2,-3
1087552282,"LOS ANGELES, CA","CROXTON, NJ",2023-07-07,8,7,-1
1087695878,"CHARLES TOWN RANSON, WV","AMOS, PQ",2023-07-07,9,10,1
1087605962,"BETHINTERMODAL, PA","ST LOUIS, MO",2023-07-07,3,5,2
3630168151,"OTTAWA, IL","LONG RIDGE, OH",2023-07-07,7,5,-2
3630193512,"MT VERNON, IL","NEWPORT, AR",2023-07-07,12,9,-3
3630150467,"UNION LANDING SIDIN, OH","DECATUR, IN",2023-07-05,8,5,-3
1086795730,"LAMBERTS POINT, VA","TOMS CREEK, VA",2023-07-07,-1,2,3
3630133758,"PAYETTE, ID","GENEVA (FGLK), NY",2023-07-07,6,4,-2
3630134584,"CHALCO, NE","BURNS HARBOR, IN",2023-07-07,4,6,2
3630127553,"TOLEDO, OH","INDIANA HARBOR, IN",2023-07-07,6,8,2
3630136748,"LA TUQUE, PQ","FOREST PARK, GA",2023-07-07,6,5,-1
3630104343,"MAGNOLIA, GA","ROBERTA, AL",2023-07-07,7,6,-1
3630193782,"LAMBERTS POINT, VA","WILLIAMSON YARD, WV",2023-07-07,1,4,3
1087522520,"CAROL, IN","FRANCISCO, IN",2023-07-07,12,9,-3
3630071207,"LOS ANGELES, CA","CROXTON, NJ",2023-07-07,4,2,-2
1087619343,"SELKIRK, NY","BUFFALO, NY",2023-07-07,10,8,-2
1087549213,"COORS CROSSING, VA","EDDYVILLE, IA",2023-07-07,8,8,0
1087574836,"LEWISTOWN, PA","WINSLOW, IN",2023-07-07,1,4,3
3630179306,"SAN BERNARDINO, CA","JACKSONVILLE, FL",2023-07-07,7,10,3
3630079174,"AUGUSTA, GA","PEORIA, IL",2023-07-07,7,10,3
3630068474,"CHICAGO, IL","COLUMBUS, OH",2023-07-07,8,7,-1
1087688596,"ST GABRIEL, LA","PINEVILLE, NC",2023-07-07,0,2,2
3630123494,"NEVILLE ISLAND, PA","ANNAWAN, IL",2023-07-07,8,8,0
3630188266,"LAFAYETTE, IN","CLYMERS, IN",2023-07-07,1,2,1
3630055714,"BUTLER, IN","BURNS HARBOR, IN",2023-07-07,9,8,-1
3630122341,"DES MOINES, IA","DES MOINES, IA",2023-07-07,2,5,3
1087644398,"ST LOUIS, MO","AUSTELL, GA",2023-07-07,7,7,0
3630072237,"LATHROP, CA","MORRISVILLE, PA",2023-07-07,2,5,3
3630080670,"HYCO, NC","BAILEY MINE, PA",2023-07-07,11,9,-2
1087565390,"YORK, PA","HOUSTON, TX",2023-07-07,4,1,-3
3630208066,"WINSLOW, IN","TERRACE, BC",2023-07-07,4,3,-1
3630084747,"RUBY, GA","JACKSONVILLE, FL",2023-07-07,8,8,0
1087690797,"GIBSON CITY, IL","AUGUSTA, GA",2023-07-07,10,8,-2
1087579975,"KANSAS CITY, MO","MELVINDALE, MI",2023-07-07,6,5,-1
3630154241,"PT EVERGLADES, FL","BLAIR, NE",2023-07-07,6,8,2
3630061951,"KANSAS CITY, MO","FT WAYNE, IN",2023-07-07,4,4,0
3630192095,"BARBERTON, OH","CINCINNATI, OH",2023-07-07,10,10,0
3630167529,"STEUBENVILLE, OH","HATFIELD, MA",2023-07-07,4,7,3
3630124898,"LOS ANGELES, CA","AUSTELL, GA",2023-07-07,1,3,2
1087688334,"ST GABRIEL, LA","FITCHBURG, MA",2023-07-07,-1,2,3
1087658745,"BURNS HARBOR, IN","DECATUR, AL",2023-07-07,9,9,0
1087653355,"CHATTANOOGA, TN","KNOXVILLE, TN",2023-07-07,3,3,0
1087555361,"JACKSONVILLE, FL","VOLTZ, MO",2023-07-07,9,6,-3
3630194649,"SANDERSVILLE, GA","WEST MONROE, LA",2023-07-07,4,5,1
3630210411,"MAHRT (CCH), AL","PORT WENTWORTH, GA",2023-07-07,3,2,-1
1087650488,"LYONS, PA","KRANNERT, GA",2023-07-07,3,1,-2
1087705110,"GEORGETOWN, KY","WA UNITED TRM (WUT), WA",2023-07-07,7,6,-1
3630175035,"AUGUSTA, GA","LULING, LA",2023-07-07,9,7,-2
1087585560,"ARBELA, MS","FT WAYNE, IN",2023-07-07,7,5,-2
3630074166,"BAYPORT, TX","KINGSPORT, TN",2023-07-07,6,5,-1
3630190483,"COFFEYVILLE, KS","EUFAULA, AL",2023-07-07,2,3,1
3630057643,"MOUNDSVILLE, WV","OLD FORGE, PA",2023-07-07,4,6,2
3630068610,"CHICAGO, IL","COLUMBUS, OH",2023-07-07,5,5,0
3630178554,"PORT ARTHUR, TX","SELMA, NC",2023-07-07,9,6,-3
3630067907,"LAFAYETTE, IN","LAFAYETTE, IN",2023-07-07,6,9,3
3630180381,"EDMONTON TFR, AB","PETERSBURG, VA",2023-07-07,13,10,-3
3630068563,"CHICAGO, IL","COLUMBUS, OH",2023-07-07,4,5,1
3630121866,"ATLANTA, GA","CALVERT, AL",2023-07-07,3,6,3
1087645425,"KAISER, MS","REYBOLD, DE",2023-07-02,0,2,2
3628671546,"CHARLOTTE, NC","WHITE PIGEON, MI",2023-07-07,5,5,0
1087671109,"BUFFALO BISON, NY","THREE OAKS, LA",2023-07-07,3,5,2
1087602833,"CRESSON, PA","CRAB ORCHARD, TN",2023-07-07,7,5,-2
3630197760,"NORTH BIRMINGHAM, AL","SPOCARI, AL",2023-07-07,-1,1,2
3630054750,"CAROL, IN","FRANCISCO, IN",2023-07-07,-1,2,3
1087605336,"SINCLAIR, WY","DECATUR, AL",2023-07-07,2,3,1
3630137566,"ROBINSON, IL","DRAGON, MS",2023-07-07,6,5,-1
3630099019,"ASHEVILLE, NC","SCIO, OH",2023-07-07,9,6,-3
1087634513,"BETHINTERMODAL, PA","DALLAS, TX",2023-07-07,0,2,2
1087662972,"EVADALE, TX","BARTON, AL",2023-07-07,4,3,-1
1087702609,"MARSHALL, MN","DOUGHERTY, GA",2023-07-07,0,3,3
3630085701,"LOS ANGELES, CA","RUTHERFORD, PA",2023-07-07,7,10,3
3630155637,"LATHROP, CA","MIAMI, FL",2023-07-07,6,9,3
3630152045,"KEOKUK, IA","ALTOONA, PA",2023-07-07,4,6,2
3630169597,"APPLE GROVE, WV","CHAPMAN, PA",2023-07-07,0,3,3
3630141777,"KANSAS CITY, MO","MELVINDALE, MI",2023-07-07,6,5,-1
3630052318,"BLUFFTON, IN","SELMA, NC",2023-07-07,-1,1,2
3630123038,"BATH, NY","REYBOLD, DE",2023-07-07,0,1,1
3630081032,"HYCO, NC","BAILEY MINE, PA",2023-07-07,3,2,-1
1087522994,"CAROL, IN","FRANCISCO, IN",2023-07-07,-1,1,2
3630076223,"MERIDIAN, MS","AUSTELL, GA",2023-07-07,2,5,3
3630074653,"CLEWISTON, FL","GARY, IN",2023-07-07,9,6,-3
1087600378,"LYNCHBURG, VA","MACMILLAN, AL",2023-07-07,5,7,2
1087556511,"RANDOLPH, MO","ELIZABETHTOWN, KY",2023-07-07,8,5,-3
1087639050,"HARRISBURG, PA","CHICAGO, IL",2023-07-07,6,7,1
3630198960,"LATHROP, CA","HARRISBURG, PA",2023-07-07,9,9,0
3630150904,"DECATUR, IL","HOMER, IL",2023-07-07,11,9,-2
1087538343,"JACKSONVILLE, FL","JACKSONVILLE, FL",2023-07-07,0,1,1
3630208723,"GLENVAR, VA","GUTHRIE, KY",2023-07-07,7,9,2
1087553199,"LOS ANGELES, CA","RUTHERFORD, PA",2023-07-07,8,6,-2
1087579983,"JACKSONVILLE, FL","ATLANTA, GA",2023-07-07,5,2,-3
1087549108,"MOORE, CA","YORK, PA",2023-07-07,-2,1,3
3630187812,"TITUSVILLE, FL","SAN BERNARDINO, CA",2023-07-07,12,9,-3
3630218037,"PRINCETON, IN","CANDLERIDGE, TX",2023-07-07,8,7,-1
3630182008,"MIDWEST PORTAGE, IN","GARY, IN",2023-07-07,2,1,-1
3630126866,"EDGERTON, IN","KINGS CREEK (DCR), MD",2023-07-07,3,1,-2
3630212528,"WINSTON-SALEM, NC","HOBBS, IN",2023-07-07,7,8,1
3630163711,"MERIDIAN, MS","GARDEN CITY, GA",2023-07-07,7,8,1
3630199047,"LEE CREEK, NC","REYBOLD, DE",2023-07-07,1,1,0
1087694547,"KIRKLAND LAKE, ON","VERTAGREEN, AL",2023-07-07,7,4,-3
3630198318,"APPLIANCE PARK, KY","APPLIANCE PARK, KY",2023-07-07,9,10,1
3630080971,"HYCO, NC","BAILEY MINE, PA",2023-07-07,5,8,3
3630148931,"DECATUR, IL","DECATUR, IL",2023-07-07,2,3,1
3630075138,"NORTH CHARLESTON, SC","JACKSON, AL",2023-07-07,2,5,3
1087523851,"BLUFFTON, IN","SELMA, NC",2023-07-07,6,5,-1
1087711624,"EAST BINGHAMTON, NY","EAST BINGHAMTON, NY",2023-07-07,8,7,-1
3630076809,"LOS ANGELES, CA","JACKSONVILLE, FL",2023-07-07,11,9,-2
3630187105,"STATE JCT, SC","GREER, SC",2023-07-02,6,9,3
3628723539,"LAMBERTS POINT, VA","TOMS CREEK, VA",2023-07-07,1,1,0
1087667809,"DAYTON, TX","SIDNEY, OH",2023-07-07,0,2,2
3630118708,"NORTH BEND, OH","ROXANA, IL",2023-07-07,1,1,0
3630061163,"CHICAGO, IL","GEORGETOWN, KY",2023-07-07,10,8,-2
1087638216,"DECATUR, IL","HOMER, IL",2023-07-07,10,9,-1
1087518343,"AUSTELL INTERMODAL, GA","KANSAS CITY, MO",2023-07-07,9,7,-2
3630192794,"CLEVELAND, OH","COLUMBUS (CUOH), OH",2023-07-07,0,3,3
1087690543,"LOUISVILLE FAIRGR, KY","DEER PARK, TX",2023-07-07,7,10,3
1087635064,"SHARONVILLE, OH","SHARONVILLE, OH",2023-07-07,11,10,-1
3630094027,"MEMPHIS, TN","JACKSONVILLE, FL",2023-07-07,13,10,-3
3630197045,"DECATUR, AL","NETTLETON, AR",2023-07-07,7,9,2
1087642786,"LOS ANGELES, CA","AUSTELL, GA",2023-07-07,-2,1,3
3630189660,"COLUMBIA CITY, IN","ST LOUIS, MO",2023-07-07,7,4,-3
3630189775,"COLUMBIA CITY, IN","ST LOUIS, MO",2023-07-07,4,2,-2
3630118114,"CRESSON, PA","CRAB ORCHARD, TN",2023-07-07,5,8,3
1087558199,"DETROIT, MI","LIVERNOIS, MI",2023-07-07,6,5,-1
3630072342,"LAGRANGE, NL","DODGE CITY, MI",2023-07-02,3,3,0
3628755798,"CAROL, IN","FRANCISCO, IN",2023-07-07,11,10,-1
1087618347,"LEMOYNE, AL","MOBILE, AL",2023-07-07,4,2,-2
3630182642,"TENNILLE, GA","BAYPORT, TX",2023-07-07,3,3,0
3630132265,"VALDOSTA, GA","NEW ORLEANS, LA",2023-07-07,5,5,0
3630096964,"NORCO, LA","SELMA, NC",2023-07-07,3,3,0
3630130611,"READING, PA","MIRAMICHI, NB",2023-07-07,7,8,1
3630052059,"BLUFFTON, IN","SELMA, NC",2023-07-07,10,9,-1
1087570882,"BOWDEN YARD, FL","BARIN, GA",2023-07-07,2,1,-1
1087639555,"GREER, SC","CHARLESTON, SC",2023-07-07,10,9,-1
3630052114,"BLUFFTON, IN","SELMA, NC",2023-07-07,9,7,-2
3630112558,"WEYCO, NC","BRAITHWAITE, LA",2023-07-07,10,9,-1
3630065434,"BIRMINGHAM, MO","DETROIT DEARBORN, MI",2023-07-07,10,7,-3
3630168957,"ROCKPORT, IN","MIDDLETOWN, OH",2023-07-07,4,7,3
3630179932,"EATON, OH","ROJAS, CU",2023-07-07,3,1,-2
3630108478,"VALDOSTA, GA","BURNSVILLE, MS",2023-07-07,4,2,-2
3630129050,"PAULSBORO, NJ","TULSA, OK",2023-07-07,11,8,-3
3630058089,"LONG BEACH E PIER, CA","CLEVELAND, OH",2023-07-07,6,3,-3
1087654440,"MERIDIAN, MS","ATLANTA, GA",2023-07-07,11,8,-3
3630093021,"WAYNESBURG, PA","BETHLEHEM, PA",2023-07-07,4,6,2
1087582740,"CLAY, DE","THOMASTON, IN",2023-07-07,10,9,-1
3630075617,"CAMPBELL ROAD YARD, OH","TOLEDO, OH",2023-07-07,7,5,-2
3630126793,"LOUISVILLE, KY","LOGANSPORT, IN",2023-07-07,4,1,-3
3630058039,"LONG BEACH E PIER, CA","CINCINNATI, OH",2023-07-07,8,10,2
3630125226,"BURNS HARBOR, IN","BURNS HARBOR, IN",2023-07-07,4,5,1
3630189791,"WEDRON, IL","ZANESVILLE, OH",2023-07-07,4,4,0
3630190988,"KINGSPORT, TN","LONGVIEW, TX",2023-07-07,5,4,-1
3630076671,"RANDOLPH, MO","ELIZABETHTOWN, KY",2023-07-07,10,7,-3
3630189783,"COLUMBIA CITY, IN","ST LOUIS, MO",2023-07-07,3,4,1
3630167367,"FT WAYNE, IN","QUINCY, IL",2023-07-07,4,3,-1
1087544687,"LEMOYNE, AL","KINGS MOUNTAIN, NC",2023-07-07,2,2,0
1087547415,"AUSTELL INTERMODAL, GA","CHARLESTON, SC",2023-07-07,-1,2,3
3630134013,"FLORENCE, SC","COLUMBIA, SC",2023-07-07,2,2,0
3630145763,"RIVER TERMINAL, NC","TEXAS CITY, TX",2023-07-07,7,5,-2
1087547253,"GARDEN CITY, GA","AUSTELL INTERMODAL, GA",2023-07-07,6,3,-3
3630197590,"ALLEMANIA, LA","NAHEOLA, AL",2023-07-07,10,8,-2
1087642710,"EAST ST LOUIS, IL","BLUFFTON, IN",2023-07-07,7,6,-1
3630177948,"SALINAS VICTORIA, NL","TOLEDO, OH",2023-07-07,12,9,-3
3630089365,"ELKHART, IN","GARNEAU, PQ",2023-07-07,9,10,1
3630195132,"CLEVELAND, OH","CLEVELAND, OH",2023-07-07,5,2,-3
3630157312,"CHICAGO, IL","FT WAYNE, IN",2023-07-07,5,8,3
3630152320,"TWIN FALLS, ID","BETHLEHEM, PA",2023-07-07,5,2,-3
3630218388,"CALVERT, AL","WATSON, CA",2023-07-07,2,2,0
1087529027,"CHICAGO ENGLEW TV, IL","BUFFALO, NY",2023-07-07,9,10,1
3630202905,"LAMBERTS POINT, VA","TOMS CREEK, VA",2023-07-07,8,7,-1
3630131552,"ARVIDA, PQ","CHESAPEAKE, VA",2023-07-07,2,2,0
3630165721,"NEW ORLEANS, LA","FT VALLEY, GA",2023-07-07,6,3,-3
3630093770,"MEMPHIS, TN","CHARLOTTE, NC",2023-07-06,10,9,-1
3629776739,"LAMBERTS POINT, VA","TOMS CREEK, VA",2023-07-07,7,5,-2
1087528770,"LONG BEACH E PIER, CA","COLUMBUS, OH",2023-07-05,13,10,-3
1086773128,"LAMBERTS POINT, VA","TOMS CREEK, VA",2023-07-07,4,1,-3
3630189610,"COLUMBIA CITY, IN","ST LOUIS, MO",2023-07-07,1,4,3
1087648203,"CHICAGO, IL","FT WAYNE, IN",2023-07-07,6,3,-3
3630059174,"LONG BEACH E PIER, CA","CINCINNATI, OH",2023-07-07,8,5,-3
1087715034,"CALVERT, AL","NORTH CHATTANOOGA, TN",2023-07-07,5,7,2
3630125682,"BURNS HARBOR, IN","BURNS HARBOR, IN",2023-07-07,4,6,2
3630180802,"CHICAGO, IL","LEXINGTON, KY",2023-07-07,7,5,-2
3630214821,"TIFTON, GA","LUBBOCK, TX",2023-07-07,5,5,0
3630212887,"WINSTON-SALEM, NC","HOBBS, IN",2023-07-07,6,3,-3
1087618672,"RANDOLPH, MO","ELIZABETHTOWN, KY",2023-07-03,9,9,0
3628888622,"WINSTON-SALEM, NC","WHITE PIGEON, MI",2023-07-07,-2,1,3
1087689550,"CANNELTON (KNWA), WV","LAMBERTS POINT, VA",2023-07-07,12,10,-2
3630056249,"MERIDIAN, MS","AUSTELL, GA",2023-07-07,13,10,-3
3630185195,"GARY, IN","MIDWEST PORTAGE, IN",2023-07-07,9,8,-1
1087543801,"RUBY, GA","JACKSONVILLE, FL",2023-07-07,-1,2,3
3630185226,"GARY, IN","MIDWEST PORTAGE, IN",2023-07-07,7,6,-1
1087574438,"MELVINDALE, MI","KANSAS CITY, MO",2023-07-07,7,10,3
3630199940,"SAN BERNARDINO, CA","AUSTELL, GA",2023-07-07,3,3,0
3630145836,"CHATTANOOGA, TN","CARTHAGE, MO",2023-07-07,-2,1,3
3630115629,"STEELTON, PA","LACASSINE, LA",2023-07-07,8,5,-3
1087672846,"JACKSONVILLE, FL","SAN BERNARDINO, CA",2023-07-07,11,9,-2
1087658892,"RADFORD, NC","BELLEVUE, OH",2023-07-07,10,9,-1
3630198067,"DILLARD, OR","PLEASANTVILLE, NJ",2023-07-07,5,2,-3
3630082965,"READING, PA","PHILA PORT RICHMOND, PA",2023-07-07,8,6,-2
3630158156,"LEMOYNE, AL","HAMILTON TFR, ON",2023-07-07,2,5,3
3630085028,"LATC, CA","HARRISBURG, PA",2023-07-07,0,2,2
1087575492,"LOS ANGELES, CA","JACKSONVILLE, FL",2023-07-07,1,2,1
1087657781,"CHICAGO, IL","AUSTELL, GA",2023-07-07,3,4,1
1087665603,"JACKSONVILLE, FL","ST LOUIS, MO",2023-07-07,3,1,-2
3630175116,"HOUSTON, TX","MORRISVILLE, PA",2023-07-07,5,7,2
3630086422,"LOS ANGELES, CA","RUTHERFORD, PA",2023-07-07,10,8,-2
3630187862,"MIAMI, FL","JACKSONVILLE, FL",2023-07-07,7,6,-1
3630057130,"LONG BEACH E PIER, CA","CINCINNATI, OH",2023-07-07,11,8,-3
3630102147,"OLD OCEAN, TX","MIDDLETOWN (DCR), DE",2023-07-07,6,9,3
1087597907,"LANDERS, IL","CLEVELAND, OH",2023-07-07,1,4,3
1087691727,"STERLING HEIGHTS, MI","ALLIANCE, TX",2023-07-07,13,10,-3
3630193342,"ST GABRIEL, LA","HUNTERSVILLE, NC",2023-07-07,7,7,0
3630190938,"KINGSPORT, TN","MAGNESS, AR",2023-07-07,10,7,-3
3630167749,"BURNS HARBOR, IN","DETROIT, MI",2023-07-07,7,5,-2
3630065280,"DENVER, CO","HARRISBURG, PA",2023-07-07,3,3,0
3630099865,"CITY OF INDUSTRY, CA","BUFFALO, NY",2023-07-07,10,7,-3
3630048602,"CICERO, IL","CROXTON, NJ",2023-07-07,6,3,-3
1087523445,"BLUFFTON, IN","SELMA, NC",2023-07-07,7,6,-1
3630076079,"MERIDIAN, MS","MIAMI, FL",2023-07-07,5,3,-2
3630067949,"CHARLOTTE INTER, NC","CHARLOTTE INTER, NC",2023-07-07,6,3,-3
1087556731,"RANDOLPH, MO","ELIZABETHTOWN, KY",2023-07-07,0,3,3
3630155077,"GRAHAM, VA","CAMERON, VA",2023-07-07,3,5,2
3630109929,"LOUISVILLE, KY","LOUISVILLE, KY",2023-07-07,2,1,-1
3630199665,"CEDAR RAPIDS, IA","SPARTANBURG, SC",2023-07-07,2,1,-1
3630213532,"RUTHERFORD, PA","RUTHERFORD, PA",2023-07-07,3,5,2
3630147406,"BROOKLAWN, LA","RINCON, GA",2023-07-07,10,7,-3
1087680001,"MERIDIAN, MS","MERIDIAN, MS",2023-07-07,9,7,-2
1087537101,"CROXTON, NJ","ATLANTA, GA",2023-07-07,5,3,-2
1087520316,"VOLTZ, MO","GCT BAYONNE, NJ",2023-07-07,9,6,-3
3630166311,"DES MOINES, IA","DES MOINES, IA",2023-07-07,6,7,1
3630127579,"TOLEDO, OH","INDIANA HARBOR, IN",2023-07-07,2,1,-1
3630071671,"LAMBERTS POINT, VA","WILLIAMSON YARD, WV",2023-07-07,7,4,-3
3630051401,"LAMBERTS POINT, VA","HAVERHILL, OH",2023-07-07,8,10,2
3630076532,"LAMBERTS POINT, VA","WILLIAMSON YARD, WV",2023-07-07,3,1,-2
3630199649,"CEDAR RAPIDS, IA","SPARTANBURG, SC",2023-07-07,3,4,1
3630212837,"WINSTON-SALEM, NC","HOBBS, IN",2023-07-07,3,4,1
3630102325,"ARBELA, MS","FT WAYNE, IN",2023-07-07,8,8,0
3630200157,"WEST HAZLETON, PA","DAYTON, TX",2023-07-02,3,2,-1
3628756841,"CAROL, IN","FRANCISCO, IN",2023-07-07,2,2,0
3630078364,"CLEVELAND, OH","VON WILLER (CCRL), OH",2023-07-07,4,1,-3
3630133237,"SELKIRK, NY","BUFFALO, NY",2023-07-07,3,4,1
3630098712,"ASHEVILLE, NC","BAYWAY, NJ",2023-07-07,4,6,2
3630135904,"BOWDEN YARD, FL","CHICAGO 47TH ST TV, IL",2023-07-07,13,10,-3
3630056037,"MERIDIAN, MS","CHARLOTTE, NC",2023-07-07,7,6,-1
3630056930,"LONG BEACH E PIER, CA","CINCINNATI, OH",2023-07-07,3,5,2
3630131667,"WEIRTON, WV","BURNS HARBOR, IN",2023-07-07,11,9,-2
3630128274,"MARTINSBURG, WV","LEETSDALE, PA",2023-07-07,2,3,1
1087705275,"BAYWAY, NJ","CHICAGO, IL",2023-07-07,10,8,-2
1087631468,"MORRISVILLE, PA","MORRISVILLE, PA",2023-07-07,9,9,0
3630193871,"LAMBERTS POINT, VA","WILLIAMSON YARD, WV",2023-07-07,6,9,3
3630119453,"ATHENS, TN","CLAYPOOL, IN",2023-07-07,9,10,1
1087555248,"CAMPBELL ROAD YARD, OH","VON WILLER (CCRL), OH",2023-07-07,7,6,-1
3630098128,"NORFOLK, VA","NORFOLK, VA",2023-07-07,1,1,0
3630059645,"LOS ANGELES, CA","RUTHERFORD, PA",2023-07-07,6,9,3
3630191188,"BAYONNE, NJ","PAULSBORO, NJ",2023-07-07,0,3,3
3630072936,"CITY OF INDUSTRY, CA","GREENSBORO, NC",2023-07-07,-1,2,3
1087679238,"BAYPORT, TX","CELCO, VA",2023-07-07,1,3,2
3630098259,"NORFOLK, VA","NORFOLK, VA",2023-07-07,0,2,2
3630108363,"VALDOSTA, GA","BURNSVILLE, MS",2023-07-07,3,5,2
3630054653,"CAROL, IN","FRANCISCO, IN",2023-07-07,12,9,-3
3630116502,"LOS ANGELES, CA","BALTIMORE, MD",2023-07-07,12,10,-2
3630187228,"DECATUR, AL","DECATUR, AL",2023-07-07,6,7,1
1087641706,"MIAMI, FL","CHICAGO 47TH ST TV, IL",2023-07-07,2,4,2
3630142634,"DAVISVILLE, RI","LAFAYETTE, IN",2023-07-06,10,7,-3
1087480223,"LAMBERTS POINT, VA","TOMS CREEK, VA",2023-07-07,11,8,-3
1087683554,"VON WILLER (CCRL), OH","CLEVELAND, OH",2023-07-07,0,2,2
1087695501,"AUSTELL, GA","GARDEN CITY, GA",2023-07-07,8,8,0
1087611785,"CHICAGO, IL","GCT BAYONNE, NJ",2023-07-07,0,1,1
1087664055,"JACKSONVILLE, FL","CHICAGO, IL",2023-07-04,3,1,-2
3629203231,"LAMBERTS POINT, VA","TOMS CREEK, VA",2023-07-07,10,9,-1
1087681976,"DECATUR, AL","DECATUR, AL",2023-07-07,8,9,1
1087665271,"CHIPMAN, NB","GRABILL, IN",2023-07-07,1,2,1
3630186044,"GEORGETOWN, KY","AGINCOURT, ON",2023-07-07,6,9,3
1087622906,"BOWDEN YARD, FL","PORTLAND, OR",2023-07-07,2,1,-1
1087692024,"MALLARD, AL","PANZACOLA, TL",2023-07-07,1,3,2
1087653004,"LACYMARK, FL","JUNCTION CITY, GA",2023-07-07,6,4,-2
3630052790,"LAMBERTS POINT, VA","WILLIAMSON YARD, WV",2023-07-07,11,8,-3
3630061969,"KANSAS CITY, MO","KANSAS CITY, MO",2023-07-02,3,5,2
3628723775,"LAMBERTS POINT, VA","TOMS CREEK, VA",2023-07-07,2,5,3
1087577004,"CLAY, DE","GIBSON CITY, IL",2023-07-07,3,1,-2
3630068513,"CHICAGO, IL","COLUMBUS, OH",2023-07-07,1,3,2
3630183973,"NORFOLK INTERNATION, VA","LANDERS, IL",2023-07-02,1,3,2
3628756312,"CAROL, IN","FRANCISCO, IN",2023-07-07,10,7,-3
3630179762,"NATRIUM, WV","DANVILLE, VA",2023-07-07,7,4,-3
3630213396,"WINSTON-SALEM, NC","MALLARD, AL",2023-07-07,9,6,-3
3630112401,"SUFFOLK, VA","MEMPHIS, TN",2023-07-07,0,3,3
3630076184,"MERIDIAN, MS","AUSTELL, GA",2023-07-03,5,5,0
3628888729,"WINSTON-SALEM, NC","WHITE PIGEON, MI",2023-07-07,0,2,2
1087655080,"FRONT ROYAL, VA","PORTSMOUTH APMT, VA",2023-07-07,3,2,-1
3630134479,"HARRISBURG, PA","HARRISBURG, PA",2023-07-07,6,8,2
3630199534,"SMITHVILLE (GSWR), GA","LEXINGTON (RJCC), KY",2023-07-07,3,2,-1
3630102113,"OLD OCEAN, TX","MILESBURG, PA",2023-07-07,10,8,-2
3630131992,"UNION BRIDGE, MD","NORFOLK, VA",2023-07-07,6,4,-2
3630122008,"ATLANTA, GA","SANDERSVILLE, GA",2023-07-07,4,2,-2
3630072960,"PORTLAND, OR","CROXTON, NJ",2023-07-07,9,10,1
3630218087,"FREEPORT, TX","MASSILLON, OH",2023-07-07,8,8,0
1087639173,"DECATUR, IL","HOMER, IL",2023-07-07,2,1,-1
1087699547,"LOS ANGELES, CA","AUSTELL, GA",2023-07-07,0,1,1
3630170190,"MUNCY (LVRR), PA","LORDSTOWN, OH",2023-07-07,2,3,1
3630129610,"SOUTH AMERICUS, GA","SYLVITE, SK",2023-07-07,11,10,-1
3630148656,"CASTANEA, PA","ALLEMANIA, LA",2023-07-07,6,6,0
3630171120,"FAIRFOREST, SC","UNION LANDING SIDIN, OH",2023-07-07,6,5,-1
3630173693,"SELMA, AL","FLORENCE, NJ",2023-07-07,8,8,0
1087594551,"TURKEY, NC","HARTFORD CITY (CERA, IN",2023-07-07,-2,1,3
1087533929,"REYBOLD, DE","YULEE, FL",2023-07-07,0,1,1
3630068636,"CHICAGO, IL","COLUMBUS, OH",2023-07-07,3,4,1
3630130718,"SUFFOLK, VA","BAYPORT, TX",2023-07-07,1,1,0
3630190996,"KINGSPORT, TN","CALVERT CITY, KY",2023-07-07,1,1,0
1087677977,"BETHINTERMODAL, PA","CHICAGO 47TH ST TV, IL",2023-07-07,1,4,3
1087578628,"PRINCETON, IN","ANGUILLA JCT, GA",2023-07-07,7,7,0
1087544190,"ROSSER, GA","BARNESVILLE, GA",2023-07-07,2,5,3
3630204258,"KRAFT, LA","FOREST PARK, GA",2023-07-07,1,4,3
3630064551,"MERIDIAN, MS","CHARLOTTE, NC",2023-07-07,2,1,-1
3630139982,"DECATUR, IL","BIRMINGHAM, AL",2023-07-07,6,6,0
3630127773,"ROANOKE, VA","SAVANNAH, GA",2023-07-07,8,5,-3
3630070358,"MODESTO, CA","JACKSONVILLE, FL",2023-07-07,2,3,1
3630185048,"WYLIE, TX","JACKSONVILLE, FL",2023-07-07,8,9,1
3630138245,"SAN BERNARDINO, CA","AUSTELL, GA",2023-07-07,7,4,-3
3630079750,"CITY OF INDUSTRY, CA","BALTIMORE, MD",2023-07-07,4,7,3
3630151120,"DECATUR, IL","HOMER, IL",2023-07-07,1,4,3
3630186353,"GREENSBORO, NC","GREENSBORO, NC",2023-07-07,3,6,3
3630146743,"ARMOREL, AR","BETHLEHEM, PA",2023-07-07,10,9,-1
3630191138,"BAYONNE, NJ","PAULSBORO, NJ",2023-07-07,3,5,2
3630197736,"MIDDLETOWN, OH","ROCKPORT, IN",2023-07-02,4,7,3
3628671392,"CHARLOTTE, NC","WHITE PIGEON, MI",2023-07-07,6,3,-3
3630065523,"LOS ANGELES, CA","RUTHERFORD, PA",2023-07-07,5,3,-2
3630152891,"KANSAS CITY, MO","MELVINDALE, MI",2023-07-07,3,5,2
1087636230,"APPLIANCE PARK, KY","NORFOLK INTERNATION, VA",2023-07-07,9,10,1
3630138766,"WAYNESBORO, VA","UNION BRIDGE, MD",2023-07-07,2,3,1
3630112809,"SAN BERNARDINO, CA","CROXTON, NJ",2023-07-07,11,9,-2
3630099190,"ROSEPORT, MN","HOPEWELL, VA",2023-07-07,6,3,-3
3630134550,"WARREN, PA","INWOOD, WV",2023-07-07,8,8,0
1087696256,"CEDAR RAPIDS, IA","SPARTANBURG, SC",2023-07-07,2,2,0
1087560594,"MOBILE, AL","ALABAMA CITY, AL",2023-07-07,7,9,2
1087705453,"FT WAYNE, IN","PIEDRAS NEGRAS, CU",2023-07-07,10,8,-2
3630058178,"LONG BEACH E PIER, CA","CLEVELAND, OH",2023-07-02,6,9,3
3628723563,"LAMBERTS POINT, VA","TOMS CREEK, VA",2023-07-07,4,5,1
1087586972,"COATESVILLE, PA","KOPPEL, PA",2023-07-07,3,2,-1
3630175750,"DAYTON, TX","HALLS FERRY JCT, NC",2023-07-07,6,6,0
1087660776,"MEIGS, GA","POSTELL, GA",2023-07-07,6,6,0
3630132134,"OXFORD, NC","BUCHANAN, VA",2023-07-07,10,10,0
3630142537,"SALINAS VICTORIA, NL","CHARLOTTE, NC",2023-07-07,8,5,-3
3630115726,"STEELTON, PA","LACASSINE, LA",2023-07-07,4,5,1
1087560950,"HYCO, NC","BAILEY MINE, PA",2023-07-07,9,10,1
3630195239,"WYLIE, TX","CHARLOTTE, NC",2023-07-07,11,10,-1
1087665132,"LAFAYETTE, IN","LAFAYETTE, IN",2023-07-07,7,8,1
3630094467,"CLAY, DE","LAFAYETTE, IN",2023-07-07,7,7,0
3630098500,"NORFOLK, VA","NORFOLK, VA",2023-07-07,5,8,3
3630094108,"MEMPHIS, TN","JACKSONVILLE, FL",2023-07-07,4,1,-3
1087561493,"HYCO, NC","BAILEY MINE, PA",2023-07-07,3,3,0
3630130522,"THOMASVILLE, PA","KAOLIN, GA",2023-07-07,7,9,2
3630060060,"CALVERT, AL","ROCK ISLAND, IL",2023-07-07,3,5,2
1087602663,"PITTSBURGH, PA","ELIZABETH MARINE TE, NJ",2023-07-07,6,7,1
3630153156,"COLUMBUS, OH","BUTLER, IN",2023-07-07,-2,1,3
3630098217,"NORFOLK, VA","NORFOLK, VA",2023-07-07,11,10,-1
3630101060,"LOS ANGELES, CA","RUTHERFORD, PA",2023-07-07,3,5,2
1087591333,"HARRISBURG, PA","CHICAGO, IL",2023-07-07,2,3,1
1087551202,"BUFFALO, NY","CHICAGO ENGLEW TV, IL",2023-07-07,4,5,1
1087693795,"NORTH BIRMINGHAM, AL","SPOCARI, AL",2023-07-07,3,6,3
3630117100,"ROSSVILLE, TN","ROSSVILLE, TN",2023-07-07,3,6,3
1087710393,"CINCINNATI, OH","ROBY, IN",2023-07-02,3,6,3
3628723270,"LAMBERTS POINT, VA","TOMS CREEK, VA",2023-07-07,1,2,1
1087546702,"MORRISVILLE, PA","CHICAGO, IL",2023-07-07,0,3,3
3630056134,"MERIDIAN, MS","JACKSONVILLE, FL",2023-07-07,3,4,1
3630176968,"FAIRFAX, KS","WALKERTOWN, NC",2023-07-07,6,4,-2
3630052172,"BLUFFTON, IN","SELMA, NC",2023-07-07,7,9,2
3630210681,"TAFT, LA","SALEM, VA",2023-07-07,4,5,1
1087556668,"RANDOLPH, MO","ELIZABETHTOWN, KY",2023-07-07,4,1,-3
3630049585,"PORT WENTWORTH, GA","SPARTA, NJ",2023-07-07,3,6,3
3630072114,"LOS ANGELES, CA","JACKSONVILLE, FL",2023-07-07,8,10,2
1087695844,"MIAMI, FL","FRANKFORT, IN",2023-07-07,6,4,-2
3630148046,"DECATUR, IL","DECATUR, IL",2023-07-07,5,4,-1
3630149351,"ELMENDORF, TX","AUGUSTA, GA",2023-07-07,8,8,0
3630068173,"CHICAGO, IL","CROXTON, NJ",2023-07-07,9,6,-3
3630175679,"WISCONSIN DAM, WI","READING, PA",2023-07-07,3,3,0
3630112469,"BUTLER, IN","DECATUR, IL",2023-07-07,7,10,3
3630090146,"HAPEVILLE, GA","LOUDON, TN",2023-07-07,3,1,-2
1087587669,"LOUDON, TN","LOUDON, TN",2023-07-07,7,5,-2
3630193287,"LAMBERTS POINT, VA","WILLIAMSON YARD, WV",2023-07-07,8,6,-2
3630196714,"MELVINDALE, MI","KANSAS CITY, MO",2023-07-07,8,10,2
3630063660,"TOLEDO AIRLINE, OH","TOLEDO AIRLINE, OH",2023-07-07,7,10,3
1087544205,"ROSSER, GA","BARNESVILLE, GA",2023-07-07,10,7,-3
1087579307,"BATH, PA","YOUNGSTOWN (YB), OH",2023-07-07,8,5,-3
3630096794,"BATH, PA","YOUNGSTOWN (YB), OH",2023-07-07,0,2,2
3630100624,"LOS ANGELES, CA","CROXTON, NJ",2023-07-07,3,1,-2
3630081317,"RUBY, GA","JACKSONVILLE, FL",2023-07-07,10,9,-1
3630180014,"CARNEYS POINT, NJ","MUNCY (LVRR), PA",2023-07-07,8,8,0
1087549637,"HARRISBURG, PA","LATHROP, CA",2023-07-07,6,8,2
1087597208,"ROSSVILLE, TN","RUTHERFORD, PA",2023-07-07,7,4,-3
1087709732,"FT WAYNE, IN","HAZLETON SHAFT BREA, PA",2023-07-07,5,5,0
1087637676,"AUSTELL, GA","GARDEN CITY, GA",2023-07-07,10,8,-2
1087638004,"PANAMA CITY, FL","ROME, GA",2023-07-07,5,2,-3
1087603677,"FARMERS VALLEY, PA","HOUSTON, TX",2023-07-07,2,5,3
1087645792,"SPRING HILL, KS","PORTLAND, IN",2023-07-07,6,5,-1
3630070293,"LAMBERTS POINT, VA","WILLIAMSON YARD, WV",2023-07-07,4,1,-3
3630208870,"VOLGA, SD","SADDLE BROOK, NJ",2023-07-07,4,3,-1
3630151104,"DECATUR, IL","HOMER, IL",2023-07-07,13,10,-3
3630066228,"NORTH BIRMINGHAM, AL","MOBILE, AL",2023-07-07,4,6,2
1087567871,"HARRISBURG, PA","CHICAGO, IL",2023-07-07,11,9,-2
3630139958,"DECATUR, IL","BIRMINGHAM, AL",2023-07-07,5,3,-2
3630130815,"MANSFIELD, OH","ELKIN, NC",2023-07-07,3,1,-2
3630129791,"DARROW, IL","LAFAYETTE, IN",2023-07-07,1,3,2
1087614995,"LOCK JOINT, SC","ALIQUIPPA, PA",2023-07-07,4,4,0
1087527986,"GREENCASTLE, PA","GREENCASTLE, PA",2023-07-07,-2,1,3
1087604152,"LEIPSIC, OH","PORTSMOUTH, OH",2023-07-07,8,6,-2
1087693737,"SANDERSVILLE, GA","WABASH, IN",2023-07-07,8,5,-3
3630072863,"WYLIE, TX","CHARLOTTE, NC",2023-07-07,6,7,1
3630099213,"ROSEPORT, MN","HOPEWELL, VA",2023-07-07,13,10,-3
1087601243,"FRONT ROYAL, VA","NORFOLK INTERNATION, VA",2023-07-07,12,10,-2
3630158994,"MEMPHIS, TN","NORFOLK, VA",2023-07-07,9,6,-3
3630136049,"GRANITE CITY, IL","HOPEWELL, VA",2023-07-07,6,4,-2
3630185886,"GRANITE CITY, IL","GRANITE CITY, IL",2023-07-07,4,1,-3
1087686463,"CLEVELAND, OH","WEST ELIZABETH, PA",2023-07-07,7,4,-3
3630208846,"LOUISVILLE, KY","LOUISVILLE, KY",2023-07-07,6,3,-3
1087549514,"CHICAGO, IL","HARRISBURG, PA",2023-07-07,5,2,-3
3630193481,"MALLARD, AL","LOUISVILLE, KY",2023-07-07,2,2,0
3630203537,"CORUNNA, ON","PIEDMONT, SC",2023-07-07,10,10,0
3630107888,"FARRELL, PA","PAULSBORO, NJ",2023-07-07,7,9,2
3630142113,"THOMASTON, IN","MONROE, MI",2023-07-07,4,7,3
3630186696,"LATC, CA","HARRISBURG, PA",2023-07-07,5,7,2
1087710856,"TIFTON, GA","LUBBOCK, TX",2023-07-07,7,6,-1
1087694466,"ROANOKE, IN","WENTZVILLE, MO",2023-07-07,2,4,2
3630107294,"SANDUSKY DOCK, OH","CROOKED CREEK MINE, PA",2023-07-07,8,8,0
3630071401,"LAMBERTS POINT, VA","WILLIAMSON YARD, WV",2023-07-07,4,7,3
3630069802,"LEMOYNE, AL","KAOLIN (CCH), AL",2023-07-07,7,5,-2
3630212277,"WINSTON-SALEM, NC","HOBBS, IN",2023-07-07,2,1,-1
1087574608,"LAFAYETTE, IN","LAFAYETTE, IN",2023-07-07,3,2,-1
3630169157,"MEIGS, GA","POSTELL, GA",2023-07-07,6,4,-2
1087693834,"WESTVACO, WY","AUBURN, NY",2023-07-07,7,10,3
1087546388,"MORRISVILLE, PA","CHICAGO, IL",2023-07-07,0,3,3
1087608423,"AVONDALE, AL","APPLE GROVE, WV",2023-07-07,10,10,0
3630127375,"BURNS HARBOR, IN","BURNS HARBOR, IN",2023-07-07,7,6,-1
3630130289,"DARROW, IL","LAFAYETTE, IN",2023-07-07,6,4,-2
1087671133,"WAYNESBORO, MS","BLANCHESTER, OH",2023-07-07,7,5,-2
3630060735,"CHICAGO, IL","TOLEDO, OH",2023-07-07,6,7,1
3630085727,"HERSHEY, PA","THREE OAKS, LA",2023-07-07,6,9,3
3630130394,"DECATUR, IL","AVON, NY",2023-07-07,6,5,-1
3630164759,"ELKHART, IN","TRINITY, MS",2023-07-07,5,6,1
1087527847,"CROXTON, NJ","HOUSTON, TX",2023-07-07,2,4,2
3630163606,"MERIDIAN, MS","RUTHERFORD, PA",2023-07-07,12,9,-3
1087545293,"DELTA, OH","PHOENIX, AZ",2023-07-07,9,6,-3
1087558327,"TOLEDO, OH","TOLEDO, OH",2023-07-07,4,6,2
3630091621,"EASTOVER, SC","WEST HAZLETON, PA",2023-07-07,5,3,-2
3630063466,"LOS ANGELES, CA","HARRISBURG, PA",2023-07-07,5,2,-3
1087675577,"SELKIRK, NY","LAFAYETTE, IN",2023-07-07,4,2,-2
3630212390,"WINSTON-SALEM, NC","HOBBS, IN",2023-07-07,6,4,-2
1087622524,"MANSFIELD, OH","FRANKFORD (DCR), DE",2023-07-07,3,3,0
3630093403,"BIRMINGHAM, MO","CHICAGO HEIGHTS, IL",2023-07-07,0,2,2
3630116439,"LATC, CA","HARRISBURG, PA",2023-07-07,10,10,0
3630197516,"ALLEMANIA, LA","KINGSPORT, TN",2023-07-07,6,4,-2
3630110865,"MIAMI, FL","CALUMET, IL",2023-07-07,10,8,-2
1087575719,"MEMPHIS, TN","CHARLOTTE, NC",2023-07-07,0,3,3
1087575824,"MEMPHIS, TN","CHARLOTTE, NC",2023-07-07,6,3,-3
3630194584,"GIBSON CITY, IL","AUGUSTA, GA",2023-07-07,5,6,1
3630175344,"TIPTON, IN","BOGALUSA, LA",2023-07-07,-1,1,2
3630051980,"BLUFFTON, IN","SELMA, NC",2023-07-07,11,8,-3
3630080492,"HYCO, NC","BAILEY MINE, PA",2023-07-03,3,1,-2
1086389694,"SANDUSKY DOCK, OH","CROOKED CREEK MINE, PA",2023-07-07,-1,2,3
1087543217,"NORTH BIRMINGHAM, AL","WADLEY, GA",2023-07-07,4,4,0
1087676175,"MOREHEAD CITY CLNA, NC","VONORE, TN",2023-07-07,10,10,0
1087687540,"HARRISBURG, PA","CHICAGO, IL",2023-07-07,3,4,1
3630168915,"MIAMI, FL","ALLEMANIA, LA",2023-07-07,2,1,-1
3630108410,"VALDOSTA, GA","BURNSVILLE, MS",2023-07-07,7,9,2
3630086935,"KANSAS CITY, MO","MELVINDALE, MI",2023-07-07,4,4,0
3630084593,"LOS ANGELES, CA","CROXTON, NJ",2023-07-07,2,2,0
3630068270,"CHICAGO, IL","RUTHERFORD, PA",2023-07-07,9,6,-3
3630126874,"DILLEY, TX","PICAYUNE, MS",2023-07-07,7,7,0
3630111502,"KANSAS CITY, MO","MELVINDALE, MI",2023-07-07,6,8,2
1087577753,"GATEWAY MINE, IL","WHEATFIELD, IN",2023-07-07,12,9,-3
1087518505,"AUSTELL INTERMODAL, GA","MIAMI, FL",2023-07-07,6,4,-2
3630148143,"DECATUR, IL","HOMER, IL",2023-07-07,6,9,3
3630167595,"MUNCY (LVRR), PA","LORDSTOWN, OH",2023-07-07,8,6,-2
3630180983,"CHICAGO, IL","LEXINGTON, KY",2023-07-07,0,3,3
1087620865,"ELKHART, IN","ELKHART, IN",2023-07-07,2,3,1
1087693884,"WINNEBAGO, MN","MACUNGIE, PA",2023-07-07,9,9,0
1087629770,"LAMBERTS POINT, VA","WILLIAMSON YARD, WV",2023-07-06,11,8,-3
1087044166,"LAMBERTS POINT, VA","TOMS CREEK, VA",2023-07-07,2,5,3
3630171243,"EVADALE, TX","BARTON, AL",2023-07-07,5,5,0
3630094417,"LOS ANGELES, CA","JACKSONVILLE, FL",2023-07-07,8,6,-2
1087597923,"LANDERS, IL","CLEVELAND, OH",2023-07-07,6,7,1
1087544572,"HARRISBURG, PA","CHICAGO, IL",2023-07-07,5,8,3
3630185137,"FT SMITH, AR","JACKSON, MI",2023-07-07,7,7,0
1087623554,"COLUMBUS, OH","NORFOLK INTERNATION, VA",2023-07-07,7,4,-3
3630166612,"BURLEY, ID","WELLINGTON, VA",2023-07-07,7,10,3
1087527936,"GREENCASTLE, PA","GREENCASTLE, PA",2023-07-07,3,2,-1
3630200165,"WEST HAZLETON, PA","NEAL, WV",2023-07-07,10,10,0
3630157867,"BURNS HARBOR, IN","BURNS HARBOR, IN",2023-07-07,11,10,-1
3630114851,"WYSOX, PA","WYEVILLE, WI",2023-07-07,-2,1,3
3630154403,"LAMBERTS POINT, VA","WILLIAMSON YARD, WV",2023-07-07,8,10,2
1087539632,"RUTHERFORD, PA","ATLANTA, GA",2023-07-07,4,3,-1
3630080311,"HYCO, NC","BAILEY MINE, PA",2023-07-07,1,2,1
3630189000,"GREENFIELD, MA","DELTA, OH",2023-07-07,2,3,1
3630133148,"SELKIRK, NY","BUFFALO, NY",2023-07-07,7,10,3
3630190661,"MOBILE, AL","LEMOYNE, AL",2023-07-07,6,6,0
3630140454,"SCIO, OH","GIBBSTOWN, NJ",2023-07-07,5,4,-1
3630121387,"MACMILLAN, AL","WINSTON-SALEM, NC",2023-07-07,9,6,-3
3630203684,"LAMBERTS POINT, VA","TOMS CREEK, VA",2023-07-07,1,1,0
1087531252,"BELLEVUE, OH","BELLEVUE, OH",2023-07-07,1,1,0
3630199843,"DAYTON, TX","WEST HAZLETON, PA",2023-07-06,9,7,-2
1087461512,"WINSTON-SALEM, NC","WHITE PIGEON, MI",2023-07-07,1,2,1
3630084250,"CALVERT, AL","INDIANA HARBOR, IN",2023-07-06,4,1,-3
1087044174,"LAMBERTS POINT, VA","TOMS CREEK, VA",2023-07-07,4,1,-3
3630078835,"ROHRERSTOWN, PA","FOSTORIA, OH",2023-07-07,0,3,3
1087715806,"DUFFS JCT (POHC), PA","NARLO, OH",2023-07-07,-1,2,3
3630189076,"GREENFIELD, MA","DELTA, OH",2023-07-07,5,3,-2
3630114330,"LANDERS, IL","LANDERS, IL",2023-07-07,12,9,-3
1087526312,"BUTLER, IN","NORTH BANGOR, ME",2023-07-07,3,2,-1
3630141426,"LAMBERTS POINT, VA","WILLIAMSON YARD, WV",2023-07-07,5,4,-1
3630152304,"DALLAS, TX","HARRISBURG, PA",2023-07-07,10,10,0
3630051354,"LAMBERTS POINT, VA","WILLIAMSON YARD, WV",2023-07-07,2,5,3
1087551896,"LOS ANGELES, CA","RUTHERFORD, PA",2023-07-06,9,8,-1
1087461499,"WINSTON-SALEM, NC","WHITE PIGEON, MI",2023-07-07,8,8,0
3630095081,"GATEWAY MINE, IL","WHEATFIELD, IN",2023-07-07,8,5,-3
3630191324,"PORT WILMINGTON, DE","AUTAUGA CREEK, AL",2023-07-07,12,10,-2
3630203707,"LAMBERTS POINT, VA","TOMS CREEK, VA",2023-07-07,2,4,2
1087637901,"OREGON, IL","TELL CITY, IN",2023-07-07,9,9,0
1087522546,"LAMBERTS POINT, VA","WILLIAMSON YARD, WV",2023-07-07,7,4,-3
3630126921,"BURNS HARBOR, IN","BURNS HARBOR, IN",2023-07-07,1,1,0
3630132809,"SELKIRK, NY","BUFFALO, NY",2023-07-07,11,8,-3
3630115564,"STEELTON, PA","LACASSINE, LA",2023-07-07,0,3,3
3630211263,"WINSTON-SALEM, NC","HOBBS, IN",2023-07-07,9,10,1
1087557753,"LOS ANGELES, CA","CROXTON, NJ",2023-07-07,12,10,-2
3630129076,"PAULSBORO, NJ","SAYRE, PA",2023-07-07,9,8,-1
3630168224,"OAKWOOD, MI","GARY, IN",2023-07-07,2,5,3
3630180234,"GILBERTON, PA","COLUMBUS, MS",2023-07-07,5,8,3
1087612286,"UNION BRIDGE, MD","NORFOLK, VA",2023-07-07,5,4,-1
3630158075,"BURNS HARBOR, IN","BURNS HARBOR, IN",2023-07-07,9,10,1
1087607752,"DES MOINES, IA","DES MOINES, IA",2023-07-07,4,4,0
3630145666,"CITY OF INDUSTRY, CA","NORFOLK, VA",2023-07-07,0,1,1
3630203634,"LAMBERTS POINT, VA","TOMS CREEK, VA",2023-07-07,4,1,-3
1087621900,"CINCINNATI, OH","TACOMA, WA",2023-07-07,9,9,0
3630148436,"DECATUR, IL","DECATUR, IL",2023-07-07,2,3,1
1087562245,"TALLADEGA, AL","VANCE, AL",2023-07-07,8,5,-3
1087714711,"FREEPORT, TX","CHAMPAIGN, IL",2023-07-07,10,10,0
1087551498,"GREENSBORO, NC","CROXTON, NJ",2023-07-07,1,3,2
3630118790,"OIL CITY, PA","LONGVIEW, TX",2023-07-07,11,10,-1
3630171146,"YOUNGSTOWN, OH","NORTH BERGEN, NJ",2023-07-07,8,5,-3
3630145616,"BIRMINGHAM, MO","DETROIT DEARBORN, MI",2023-07-07,5,4,-1
1087645653,"CHICAGO, IL","CHICAGO, IL",2023-07-07,12,9,-3
3630088157,"BOWDEN YARD, FL","BARIN, GA",2023-07-07,9,7,-2
1087522902,"LAMBERTS POINT, VA","WILLIAMSON YARD, WV",2023-07-07,-2,1,3
1087679741,"KANSAS CITY, MO","NORFOLK INTERNATION, VA",2023-07-07,6,8,2
3630074792,"WILLOW SPRINGS, IL","WILLOW SPRINGS, IL",2023-07-07,8,6,-2
3630115108,"JOHNSTOWN, PA","L'ORIGNAL SPUR, ON",2023-07-07,11,8,-3
3630205123,"NORTH BIRMINGHAM, AL","SALTILLO, CU",2023-07-07,2,4,2
1087595191,"PINEVILLE, NC","CHICAGO, IL",2023-07-07,9,7,-2
3630132142,"BOISE SOUTHERN, LA","EAST POINT, GA",2023-07-07,8,10,2
3630091118,"WINSTON-SALEM, NC","WHITE PIGEON, MI",2023-07-07,11,10,-1
1087530206,"LONG BEACH E PIER, CA","COLUMBUS, OH",2023-07-07,0,2,2
1087653313,"ZORRA, ON","GORDON, GA",2023-07-07,7,9,2
3630193562,"LAMBERTS POINT, VA","WILLIAMSON YARD, WV",2023-07-07,10,9,-1
3630157362,"COLQUITT, GA","LEXINGTON (RJCC), KY",2023-07-07,1,4,3
3630056639,"LAMBERTS POINT, VA","WILLIAMSON YARD, WV",2023-07-07,8,10,2
3630058657,"LONG BEACH E PIER, CA","COLUMBUS, OH",2023-07-07,9,8,-1
1087620904,"LOGISTICS PARK KANS, KS","KANSAS CITY, MO",2023-07-07,1,2,1
3630120802,"CATAWBA, SC","NORANDA, PQ",2023-07-07,3,1,-2
3630188355,"LAFAYETTE, IN","ALBION, MI",2023-07-07,5,2,-3
3630092229,"WELLSBORO, PA","WYEVILLE, WI",2023-07-07,0,2,2
1087625637,"CATAWBA, SC","NEW CARLISLE, IN",2023-07-07,3,2,-1
3630155912,"CLAYPOOL, IN","NEW HYDE PARK, NY",2023-07-07,6,9,3
3630124513,"ERIE, PA","OLD OCEAN, TX",2023-07-07,7,6,-1
3630210267,"BROOKLAWN, LA","RINCON, GA",2023-07-07,6,6,0
3630192118,"EAST ST LOUIS, IL","LOUISVILLE, KY",2023-07-07,10,9,-1
1087703574,"WINSLOW, IN","TERRACE, BC",2023-07-07,7,10,3
1087663839,"RUTHERFORD, PA","KANSAS CITY, MO",2023-07-07,3,5,2
3630212057,"WINSTON-SALEM, NC","HOBBS, IN",2023-07-07,7,6,-1
3630115572,"STEELTON, PA","LACASSINE, LA",2023-07-07,10,9,-1
1087714630,"LOS ANGELES, CA","AUSTELL, GA",2023-07-07,2,4,2
1087679068,"LAKE CHARLES, LA","ASHEBORO, NC",2023-07-07,1,4,3
3630205709,"WARRENTON, OH","SPARTA, WI",2023-07-07,6,4,-2
3630075285,"BROADWAY, VA","LINVILLE, VA",2023-07-02,7,10,3
3628722981,"LAMBERTS POINT, VA","TOMS CREEK, VA",2023-07-07,1,4,3
1087549564,"HARRISBURG, PA","CHICAGO, IL",2023-07-07,8,8,0
3630211467,"CEDAR PORT, TX","CLYDE, OH",2023-07-07,5,2,-3
3630163258,"DALLAS, TX","CROXTON, NJ",2023-07-07,11,9,-2
3630081058,"HYCO, NC","BAILEY MINE, PA",2023-07-07,11,9,-2
1087550858,"CHICAGO 47TH ST TV, IL","HARRISBURG, PA",2023-07-07,-1,1,2
3630107561,"SANDUSKY DOCK, OH","CROOKED CREEK MINE, PA",2023-07-07,6,9,3
1087588097,"MAGNOLIA, GA","ROBERTA, AL",2023-07-07,9,10,1
3630072601,"LAGRANGE, NL","STERLING HEIGHTS, MI",2023-07-07,2,4,2
3630185250,"GARY, IN","MIDWEST PORTAGE, IN",2023-07-02,2,4,2
3628671198,"CHARLOTTE, NC","WHITE PIGEON, MI",2023-07-07,0,3,3
1087684673,"GOOD SPRING, PA","PAULSBORO, NJ",2023-07-07,-2,1,3
3630161662,"WAYNE, MI","MALLARD, AL",2023-07-07,4,5,1
1087600085,"MAPLE HEIGHTS, OH","ICTF, CA",2023-07-03,5,2,-3
3629053555,"LAMBERTS POINT, VA","TOMS CREEK, VA",2023-07-07,10,10,0
3630211784,"ACKLEY, IA","DORAVILLE, GA",2023-07-07,-1,2,3
1087615991,"BURNS HARBOR, IN","BURNS HARBOR, IN",2023-07-07,4,5,1
1087566744,"BOWDEN YARD, FL","CHARLOTTE, NC",2023-07-07,8,5,-3
3630118805,"FARMERS VALLEY, PA","PHILA PORT RICHMOND, PA",2023-07-07,12,10,-2
3630104987,"ROGERSLACY, MS","NAMPA, AB",2023-07-07,12,9,-3
1087680093,"MERIDIAN, MS","MERIDIAN, MS",2023-07-07,9,9,0
3630163070,"CHICAGO, IL","CHICAGO MIX CTR, IL",2023-07-07,10,9,-1
1087622980,"BOWDEN YARD, FL","CHICAGO 47TH ST TV, IL",2023-07-07,9,9,0
3630126735,"UNION BRIDGE, MD","NORFOLK, VA",2023-07-07,9,8,-1
1087566613,"BOWDEN YARD, FL","CHICAGO 47TH ST TV, IL",2023-07-07,0,3,3
3630108931,"ZANESVILLE, OH","WEDRON, IL",2023-07-07,11,9,-2
3630148460,"DECATUR, IL","DECATUR, IL",2023-07-07,4,3,-1
1087561998,"MOBILE, AL","MOBILE, AL",2023-07-07,9,6,-3
1087709651,"NEW CASTLE, PA","WILLIAMSPORT, PA",2023-07-07,5,2,-3
1087550361,"CHICAGO, IL","CHARLOTTE, NC",2023-07-07,2,5,3
1087601780,"ROSSVILLE, TN","ROSSVILLE, TN",2023-07-07,12,9,-3
3630070497,"LAMBERTS POINT, VA","WILLIAMSON YARD, WV",2023-07-07,4,5,1
1087576668,"KANSAS CITY, MO","MELVINDALE, MI",2023-07-07,7,4,-3
3630168842,"MIAMI, FL","LANDERS, IL",2023-07-07,7,7,0
3630062046,"BELLEVUE, OH","BELLEVUE, OH",2023-07-07,5,6,1
1087658931,"OAKWOOD, MI","GARY, IN",2023-07-07,6,8,2
1087592656,"LOUISVILLE, KY","LOUISVILLE, KY",2023-07-07,3,4,1
3630060230,"KANSAS CITY, MO","KANSAS CITY, MO",2023-07-07,7,7,0
3630189092,"GREENFIELD, MA","DELTA, OH",2023-07-07,8,10,2
3630152477,"RIVER ROUGE, MI","BRAMPTON, GA",2023-07-07,4,3,-1
3630093217,"LOS ANGELES, CA","RUTHERFORD, PA",2023-07-07,2,4,2
3630065133,"LOS ANGELES, CA","CROXTON, NJ",2023-07-07,10,10,0
3630199704,"CEDAR RAPIDS, IA","CITY POINT, FL",2023-07-07,3,4,1
1087594878,"NEWBERRY, PA","WYEVILLE, WI",2023-07-07,4,4,0
3630207751,"BRISTOL, VA","TROUTVILLE, VA",2023-07-07,5,8,3
1087531430,"BELLEVUE, OH","BELLEVUE, OH",2023-07-07,4,7,3
3630211190,"WINSTON-SALEM, NC","HOBBS, IN",2023-07-07,11,8,-3
3630092978,"WAYNESBURG, PA","BETHLEHEM, PA",2023-07-07,10,7,-3
3630198148,"LOS ANGELES, CA","AUSTELL, GA",2023-07-07,4,2,-2
1087555612,"CINCINNATI, OH","JACKSONVILLE, FL",2023-07-07,7,8,1
1087617294,"REYBOLD, DE","LYONS, PA",2023-07-07,3,1,-2
3630177540,"HOUSTON, TX","SIEGFRIED, PA",2023-07-07,10,7,-3
3630108046,"FARRELL, PA","PAULSBORO, NJ",2023-07-07,6,5,-1
1087683805,"GREENFIELD, MA","DELTA, OH",2023-07-07,8,7,-1
1087557999,"BUFFALO, NY","OWEGO (OHRY), NY",2023-07-07,9,9,0
3630185187,"WILLIAMSPORT, MD","BAYPORT, TX",2023-07-07,8,7,-1
3630093712,"MEMPHIS, TN","CHARLOTTE, NC",2023-07-07,2,2,0
3630110182,"CLARKSON, ON","BAYWAY, NJ",2023-07-07,4,3,-1
3630056689,"LAMBERTS POINT, VA","WILLIAMSON YARD, WV",2023-07-07,8,10,2
3630071223,"SCHENECTADY, NY","TAYLOR, PA",2023-07-07,5,5,0
3630180284,"GILBERTON, PA","DELTA, OH",2023-07-07,11,8,-3
3630125527,"KANSAS CITY, MO","MELVINDALE, MI",2023-07-07,2,2,0
1087640750,"WOODSTOCK, ON","WESTLAKE, FL",2023-07-07,3,3,0
3630203016,"LAMBERTS POINT, VA","TOMS CREEK, VA",2023-07-07,0,3,3
1087578042,"GATEWAY MINE, IL","WHEATFIELD, IN",2023-07-07,9,10,1
3630203626,"LAMBERTS POINT, VA","TOMS CREEK, VA",2023-07-07,6,8,2
3630126777,"BURNS HARBOR, IN","NEW CARLISLE, IN",2023-07-02,3,3,0
3628723466,"LAMBERTS POINT, VA","TOMS CREEK, VA",2023-07-07,2,2,0
3630052708,"BLUFFTON, IN","SELMA, NC",2023-07-07,6,9,3
3630198619,"PRESA DE LA CEBADA, GJ","LEIPSIC, OH",2023-07-07,2,4,2
1087675674,"SELKIRK, NY","LAFAYETTE, IN",2023-07-07,11,8,-3
3630124270,"STEARNS, KY","NEWPORT, AR",2023-07-07,3,1,-2
1087602508,"PITTSBURGH, PA","ELIZABETH MARINE TE, NJ",2023-07-07,8,9,1
3630205547,"ROCKPORT, IN","MIDDLETOWN, OH",2023-07-07,11,9,-2
3630162294,"LACYMARK, FL","JUNCTION CITY, GA",2023-07-07,5,4,-1
3630115784,"HAMILTON, MS","MCINTOSH, AL",2023-07-02,10,7,-3
3628722999,"LAMBERTS POINT, VA","TOMS CREEK, VA",2023-07-07,6,8,2
1087645750,"GRAHAM, VA","CAMERON, VA",2023-07-07,2,3,1
3630189636,"COLUMBIA CITY, IN","ST LOUIS, MO",2023-07-06,4,5,1
3629821039,"SURRENCY, GA","ANDERSON (ICRK), IN",2023-07-07,6,4,-2
3630212950,"WINSTON-SALEM, NC","HOBBS, IN",2023-07-07,5,2,-3
3630098592,"ASHEVILLE, NC","PINE BLUFF, AR",2023-07-07,4,2,-2
3630132671,"SELKIRK, NY","BUFFALO, NY",2023-07-07,6,8,2
3630199356,"SALISBURY (DCR), MD","MCDONOUGH, GA",2023-07-07,11,8,-3
3630132930,"SELKIRK, NY","BUFFALO, NY",2023-07-07,8,10,2
3630122715,"CHICAGO ASHLAND AVE, IL","PORT WENTWORTH, GA",2023-07-07,7,4,-3
1087524239,"CRAWFORDSVILLE, IN","PEKIN, IL",2023-07-07,11,8,-3
1087681845,"LIVERNOIS, MI","CANTON, OH",2023-07-07,2,4,2
3630111667,"CHARLESTON, SC","SAVANNAH, GA",2023-07-07,7,9,2
3630102163,"ELDON, TX","NORTH CHARLESTON, SC",2023-07-07,9,9,0
1087537826,"MORRISVILLE TV, PA","CHICAGO ENGLEW TV, IL",2023-07-07,4,2,-2
3630066862,"CINCINNATI, OH","CINCINNATI, OH",2023-07-07,0,3,3
3630146036,"EAST MODESTO, CA","HANNIBAL, MO",2023-07-07,3,1,-2
1087700055,"KRAFT, LA","FOREST PARK, GA",2023-07-07,6,6,0
3630181125,"LAFAYETTE, GA","JACKSONVILLE, AR",2023-07-07,10,8,-2
1087525829,"ST LOUIS, MO","JACKSONVILLE, FL",2023-07-07,7,4,-3
3630052669,"BLUFFTON, IN","SELMA, NC",2023-07-07,2,4,2
3630070421,"ROSSVILLE, TN","ROSSVILLE, TN",2023-07-07,1,2,1
1087686730,"ATLANTA, GA","WYLIE, TX",2023-07-07,4,2,-2
1087563615,"CALVERT CITY, KY","EMORY GAP, TN",2023-07-07,5,4,-1
3630163282,"BALDWIN, GA","DECATUR, IL",2023-07-07,5,2,-3
3630086668,"CITY OF INDUSTRY, CA","GREENSBORO, NC",2023-07-07,2,2,0
1087667778,"TIPTON, IN","MACMILLAN, AL",2023-07-07,2,1,-1
3630161492,"LAMBERTS POINT, VA","WILLIAMSON YARD, WV",2023-07-07,-1,1,2
3630110027,"LOUISVILLE, KY","LOUISVILLE, KY",2023-07-07,4,1,-3
3630133009,"SELKIRK, NY","BUFFALO, NY",2023-07-07,4,4,0
3630142951,"STAPLETON, GA","EAST STROUDSBURG, PA",2023-07-07,2,3,1
3630193960,"LAMBERTS POINT, VA","WILLIAMSON YARD, WV",2023-07-07,12,10,-2
3630121078,"TOLEDO, OH","MIDDLETOWN, OH",2023-07-07,1,3,2
1087596812,"PITTSBURGH, PA","ELIZABETH MARINE TE, NJ",2023-07-07,3,6,3
3630095934,"FREMONT, OH","HURON, CA",2023-07-07,4,2,-2
3630205961,"JACKSON, MI","CROFT, NC",2023-07-07,11,9,-2
1087604259,"ATLANTA, GA","WYLIE, TX",2023-07-07,9,7,-2
3630112037,"PRESCOTT, ON","TOLEDO, OH",2023-07-07,0,3,3
3630100187,"INWOOD, WV","CHICAGO, IL",2023-07-07,6,7,1
1087573131,"APPLIANCE PARK, KY","ELIZABETH MARINE TE, NJ",2023-07-07,7,8,1
3630181078,"NORFOLK, VA","AIKEN (AIKR), SC",2023-07-07,1,1,0
3630058063,"LONG BEACH E PIER, CA","CINCINNATI, OH",2023-07-07,2,3,1
3630187121,"DECATUR, AL","DECATUR, AL",2023-07-07,7,6,-1
3630098461,"NORFOLK, VA","NORFOLK, VA",2023-07-07,-1,1,2
3630137192,"PINEVILLE, NC","AUGUSTA, MS",2023-07-07,11,10,-1
1087654296,"MERIDIAN, MS","RUTHERFORD, PA",2023-07-07,-1,1,2
3630213338,"RIVER ROUGE, MI","HOUSTON, TX",2023-07-07,9,10,1
1087589255,"BIGLERVILLE, PA","CHICAGO, IL",2023-07-07,0,1,1
3630168062,"MOUNDVILLE, AL","ERIE, PA",2023-07-07,7,4,-3
1087650713,"COLUMBUS, OH","NORFOLK INTERNATION, VA",2023-07-07,9,7,-2
3630086618,"HUBER, GA","SANDERSVILLE, GA",2023-07-07,10,9,-1
3630086642,"LOS ANGELES, CA","AUSTELL, GA",2023-07-07,8,8,0
1087531919,"BELLEVUE, OH","BELLEVUE, OH",2023-07-07,5,8,3
3630052619,"BLUFFTON, IN","SELMA, NC",2023-07-04,7,4,-3
1086399576,"SANDUSKY DOCK, OH","CROOKED CREEK MINE, PA",2023-07-07,3,5,2
3630059792,"SAN BERNARDINO, CA","CHARLOTTE, NC",2023-07-07,9,6,-3
3630086024,"CLEVELAND, TN","DAYTON, OH",2023-07-07,7,10,3
1087631379,"DAVISVILLE, RI","LAFAYETTE, IN",2023-07-07,5,6,1
1087528762,"LONG BEACH E PIER, CA","CLEVELAND, OH",2023-07-07,1,4,3
3630211734,"ACKLEY, IA","DORAVILLE, GA",2023-07-07,5,6,1
3630070332,"MODESTO, CA","SCRANTON, PA",2023-07-07,6,8,2
1087693038,"RUTHERFORD, PA","ATLANTA, GA",2023-07-07,5,2,-3
3630069331,"ROSSER, GA","BARNESVILLE, GA",2023-07-07,3,2,-1
3630099572,"THOMASVILLE, PA","BENTONITE, WY",2023-07-07,5,4,-1
3630062004,"LOS ANGELES, CA","CROXTON, NJ",2023-07-07,4,1,-3
1087598262,"LOS ANGELES, CA","AUSTELL, GA",2023-07-07,1,1,0
3630117231,"DES MOINES, IA","DES MOINES, IA",2023-07-07,1,3,2
3630121874,"HAMILTON, ON","CHICAGO, IL",2023-07-06,6,3,-3
1087461481,"WINSTON-SALEM, NC","WHITE PIGEON, MI",2023-07-07,6,9,3
3630199063,"LEE CREEK, NC","REYBOLD, DE",2023-07-07,1,3,2
3630141507,"ASHEVILLE, NC","GIANT, SC",2023-07-07,0,2,2
1087611735,"BURNS HARBOR, IN","COATESVILLE, PA",2023-07-07,13,10,-3
1087606730,"INSTITUTE (KNWA), WV","TAFT, LA",2023-07-07,6,8,2
1087649908,"FARRELL, PA","PAULSBORO, NJ",2023-07-07,12,10,-2
3630183096,"MELVINDALE, MI","KANSAS CITY, MO",2023-07-07,3,6,3
3630218134,"AVON, NY","FRANKFORD (DCR), DE",2023-07-07,12,10,-2
1087593791,"ELKHART, IN","GARY, IN",2023-07-07,10,7,-3
3630172273,"CEDAR RAPIDS, IA","KENDALLVILLE (KTR), IN",2023-07-07,10,10,0
3630066901,"PHOENIX, AZ","CROXTON, NJ",2023-07-02,9,8,-1
3628671902,"LAMBERTS POINT, VA","TOMS CREEK, VA",2023-07-07,10,9,-1
3630216190,"EAST ST LOUIS, IL","WENTZVILLE, MO",2023-07-07,9,8,-1
3630052164,"BLUFFTON, IN","SELMA, NC",2023-07-07,2,2,0
3630133164,"SELKIRK, NY","BUFFALO, NY",2023-07-07,11,8,-3
3630124474,"WOODSTOCK, ON","COMMERCE, GA",2023-07-07,3,3,0
1087711616,"STOCKTON IMF, CA","JACKSONVILLE, FL",2023-07-07,6,5,-1
3630115213,"KALAMAZOO, MI","SANDERSVILLE, GA",2023-07-07,1,1,0
1087659288,"MUNCY (LVRR), PA","LORDSTOWN, OH",2023-07-07,3,6,3
3630204761,"POSTELL, GA","ODUM, GA",2023-07-07,3,3,0
1087711690,"SELMA, AL","QUINNESEC, MI",2023-07-07,4,7,3
1087543681,"HARRISBURG, PA","CHICAGO, IL",2023-07-07,11,9,-2
3630196950,"WESTVACO, WY","AUBURN, NY",2023-07-07,8,10,2
3630111308,"LOS ANGELES, CA","HARRISBURG, PA",2023-07-07,-1,2,3
1087546249,"DETROIT, MI","LIVERNOIS, MI",2023-07-02,5,5,0
3628723335,"LAMBERTS POINT, VA","TOMS CREEK, VA",2023-07-07,4,2,-2
3630114136,"MIAMI, FL","CINCINNATI, OH",2023-07-07,6,5,-1
1087612236,"MALLARD, AL","DECATUR, AL",2023-07-07,6,4,-2
3630054645,"CAROL, IN","FRANCISCO, IN",2023-07-07,4,7,3
3630080476,"HYCO, NC","BAILEY MINE, PA",2023-07-07,6,6,0
3630139851,"BAUXITE, AR","LEETSDALE, PA",2023-07-07,8,9,1
3630190506,"LATHROP, CA","CHARLOTTE, NC",2023-07-07,-1,1,2
1087681900,"DECATUR, AL","DECATUR, AL",2023-07-07,7,8,1
1087694644,"WYLIE, TX","RUTHERFORD, PA",2023-07-07,3,2,-1
3630054556,"CAROL, IN","FRANCISCO, IN",2023-07-07,7,8,1
3630212659,"WINSTON-SALEM, NC","HOBBS, IN",2023-07-07,8,9,1
1087556977,"CICERO, IL","MORRISVILLE, PA",2023-07-07,1,1,0
3630056744,"GARYVILLE, LA","MIDLAND, NC",2023-07-02,0,2,2
3628757148,"CAROL, IN","FRANCISCO, IN",2023-07-07,4,4,0
3630074645,"CLEWISTON, FL","TYNER, TN",2023-07-07,2,3,1
3630136015,"WEST HAZLETON, PA","ORANGE, TX",2023-07-07,8,6,-2
3630121793,"AGINCOURT, ON","ABERDEEN, MS",2023-07-07,4,6,2
3630154990,"PRINCETON, LA","PETROLIA, PA",2023-07-07,11,9,-2
1087566891,"HERSHEY, PA","BALTIMORE, MD",2023-07-07,4,5,1
3630180739,"SANDY SPRINGS, SC","PARKERSBURG, WV",2023-07-07,6,7,1
3630194534,"GENEVA (FGLK), NY","LEBANON, PA",2023-07-07,8,5,-3
3630098681,"ASHEVILLE, NC","FALLON, NV",2023-07-07,3,1,-2
3630186735,"LATC, CA","CINCINNATI, OH",2023-07-07,5,7,2
1087601730,"ATLANTA, GA","RUTHERFORD, PA",2023-07-07,5,7,2
3630141997,"MEADVILLE, PA","EDGERTON, IN",2023-07-07,9,6,-3
3630162252,"LACYMARK, FL","JUNCTION CITY, GA",2023-07-07,4,2,-2
1087702861,"CLINTON, IA","ELWOOD, IN",2023-07-07,11,9,-2
3630194186,"WEST POINT, VA","SCIO, OH",2023-07-07,2,2,0
3630113457,"SWEETWATER, TX","DECATUR, IL",2023-07-07,5,4,-1
1087527708,"HARRISBURG, PA","CHICAGO, IL",2023-07-07,10,7,-3
3630218184,"LAKEVILLE, NY","KINGS CREEK (DCR), MD",2023-07-07,7,7,0
1087649461,"WEIRTON, WV","BURNS HARBOR, IN",2023-07-07,9,7,-2
1087555264,"CAMPBELL ROAD YARD, OH","TOLEDO, OH",2023-07-07,11,10,-1
3630122595,"HOUSTON, TX","PEDRICKTOWN, NJ",2023-07-07,11,10,-1
3630048589,"CICERO, IL","CROXTON, NJ",2023-07-07,12,9,-3
3630130598,"READING, PA","MORRIS, MB",2023-07-07,1,3,2
3630111196,"EL DORADO, AR","HOLSTON, TN",2023-07-07,10,9,-1
1087706881,"WINSTON-SALEM, NC","HOBBS, IN",2023-07-07,9,10,1
3630174990,"AUGUSTA, GA","LULING, LA",2023-07-07,4,3,-1
3630099255,"SOUTH TEXARKANA, TX","HILL, AL",2023-07-07,6,6,0
1087583241,"INWOOD, WV","CHICAGO, IL",2023-07-07,6,5,-1
3630065743,"DECATUR, IL","BIG ISLAND, WY",2023-07-07,9,8,-1
3630141036,"PETERSBURG, VA","DAYMAN, IA",2023-07-07,8,10,2
1087613274,"TOLEDO, OH","INDIANA HARBOR, IN",2023-07-07,9,7,-2
1087617252,"HUNTSVILLE, AL","GARDEN CITY, GA",2023-07-07,10,8,-2
1087558717,"DET JEFFERSON, MI","COTTAGE GROVE, MN",2023-07-07,7,10,3
1087644819,"PT EVERGLADES, FL","BLAIR, NE",2023-07-07,0,2,2
3630073348,"CHICAGO, IL","CYRUS, WV",2023-07-07,2,1,-1
3630189563,"COLUMBIA CITY, IN","ST LOUIS, MO",2023-07-07,8,8,0
3630145705,"CITY OF INDUSTRY, CA","PITTSBURGH, PA",2023-07-07,6,8,2
1087567897,"KANSAS CITY, MO","MELVINDALE, MI",2023-07-02,7,9,2
3628723783,"LAMBERTS POINT, VA","TOMS CREEK, VA",2023-07-07,2,2,0
3630072164,"CHARLESTON, SC","CHARLOTTE, NC",2023-07-07,5,8,3
3630219180,"KANSAS CITY, MO","HIGH HILL, MO",2023-07-07,6,7,1
1087646073,"ELIZABETH MARINE TE, NJ","CHICAGO, IL",2023-07-07,4,2,-2
1087561134,"HYCO, NC","BAILEY MINE, PA",2023-07-07,4,2,-2
3630203155,"LAMBERTS POINT, VA","TOMS CREEK, VA",2023-07-07,10,7,-3
3630175409,"DAYTON, TX","SIDNEY, OH",2023-07-07,12,10,-2
1087648740,"WEIRTON, WV","BURNS HARBOR, IN",2023-07-06,3,3,0
3629821233,"SURRENCY, GA","ANDERSON (ICRK), IN",2023-07-07,5,5,0
3630154592,"LUDLOWVILLE (ITHR), NY","SHELBURNE, VT",2023-07-07,-2,1,3
3630211213,"WINSTON-SALEM, NC","HOBBS, IN",2023-07-07,10,10,0
1087670250,"JACKSONVILLE, FL","CHICAGO, IL",2023-07-07,5,2,-3
3630163232,"DALLAS, TX","HARRISBURG, PA",2023-07-07,10,8,-2
3630199584,"CEDAR RAPIDS, IA","PETERSBURG, VA",2023-07-07,4,1,-3
1087574488,"PRINCETON, IN","MIRA LOMA, CA",2023-07-07,3,4,1
3630063610,"TUNKHANNOCK, PA","CLAYTON, IA",2023-07-07,4,3,-1
3630094213,"MEMPHIS, TN","AUSTELL INTERMODAL, GA",2023-07-07,5,5,0
3630073372,"STEVENS POINT, WI","SANDERSVILLE, GA",2023-07-07,2,3,1
3630186654,"CANTON, OH","WAUPACA, WI",2023-07-07,4,5,1
3630185179,"WHITE CITY, OR","DELAIR, NJ",2023-07-07,2,2,0
1087615755,"DARROW, IL","LAFAYETTE, IN",2023-07-07,4,4,0
3630205107,"NORTH BIRMINGHAM, AL","XALOSTOC, EM",2023-07-07,1,1,0
3630074912,"ORANGE, TX","TAYLORSVILLE, NC",2023-07-07,-1,2,3
1087641780,"NORTH BIRMINGHAM, AL","MILLPORT, AL",2023-07-07,0,1,1
3630170687,"ARBELA, MS","COLUMBUS, OH",2023-07-07,13,10,-3
1087588152,"KRANNERT, GA","ST LOUIS, MI",2023-07-07,12,9,-3
3630180072,"DEMOPOLIS, AL","HILL, AL",2023-07-07,3,4,1
1087603774,"LOS ANGELES, CA","RUTHERFORD, PA",2023-07-07,9,10,1
3630155750,"CHICAGO, IL","CHICAGO MIX CTR, IL",2023-07-07,10,7,-3
3630118554,"CRESSON, PA","CLEVELAND, OH",2023-07-07,6,3,-3
3630122529,"HOUSTON, TX","PEDRICKTOWN, NJ",2023-07-07,3,4,1
3630212138,"WARREN, GA","PORT WENTWORTH, GA",2023-07-07,8,6,-2
3630122090,"READING, PA","MODESTO, CA",2023-07-07,7,8,1
1087519878,"VOLTZ, MO","RUTHERFORD, PA",2023-07-07,3,1,-2
3630163957,"GENEVA, NY","MAPLETON, PA",2023-07-07,9,6,-3
3630058940,"CALUMET, IL","CALUMET, IL",2023-07-07,10,8,-2
1087532630,"CALUMET, IL","CHARLOTTE, NC",2023-07-07,5,7,2
3630162600,"MONROE, MI","HAINESPORT, NJ",2023-07-07,0,2,2
3630117299,"DES MOINES, IA","DES MOINES, IA",2023-07-07,11,8,-3
3630174801,"ICTF, CA","COLUMBUS, OH",2023-07-07,5,5,0
3630100137,"INWOOD, WV","CHICAGO, IL",2023-07-07,1,2,1
3630182472,"SANDERSVILLE, GA","ORANGEBURG, SC",2023-07-07,7,8,1
3630095227,"GATEWAY MINE, IL","WHEATFIELD, IN",2023-07-07,13,10,-3
3630175360,"TIPTON, IN","MACMILLAN, AL",2023-07-07,2,1,-1
3630167715,"BURNS HARBOR, IN","RIVER ROUGE, MI",2023-07-07,2,5,3
3630077091,"CICERO, IL","HARRISBURG, PA",2023-07-07,6,7,1
3630052009,"BLUFFTON, IN","SELMA, NC",2023-07-07,9,7,-2
3630188478,"LAFAYETTE, IN","ALBION, MI",2023-07-07,1,4,3
3630075308,"BROADWAY, VA","LINVILLE, VA",2023-07-07,5,2,-3
1087638876,"DECATUR, IL","HOMER, IL",2023-07-02,5,3,-2
3628671300,"CHARLOTTE, NC","WHITE PIGEON, MI",2023-07-07,1,2,1
1087564043,"CALVERT CITY, KY","EMORY GAP, TN",2023-07-07,5,4,-1
3630079221,"WYLIE, TX","ATLANTA, GA",2023-07-07,11,9,-2
3630190954,"KINGSPORT, TN","MAGNESS, AR",2023-07-07,5,6,1
1087665598,"AUSTELL, GA","LATHROP, CA",2023-07-07,2,4,2
1087625679,"GREENSBORO, NC","PORTLAND, IN",2023-07-07,12,10,-2
1087559690,"WINSTON-SALEM, NC","RABER, IN",2023-07-07,3,6,3
3630193368,"CINCINNATI, OH","CINCINNATI, OH",2023-07-07,5,4,-1
1087548916,"CANTON, OH","DYER, PA",2023-07-07,2,3,1
3630133172,"SELKIRK, NY","BUFFALO, NY",2023-07-07,3,3,0
3630109131,"NORFOLK NPBL, VA","ARVIDA, PQ",2023-07-07,7,6,-1
3630074881,"LANDERS, IL","LANDERS, IL",2023-07-07,8,9,1
3630075950,"MERIDIAN, MS","CHARLOTTE, NC",2023-07-07,12,10,-2
3630050138,"DELTA, OH","SALT LAKE CITY, UT",2023-07-07,5,3,-2
1087539072,"RICHMOND, VA","TROUTVILLE, VA",2023-07-07,10,7,-3
3630117574,"CLOVER BAR, AB","CHICAGO, IL",2023-07-07,9,6,-3
1087658460,"MACMILLAN, AL","TIPTON, IN",2023-07-07,7,7,0
1087601803,"ROSSVILLE, TN","ROSSVILLE, TN",2023-07-07,6,6,0
3630064381,"RICHMOND, VA","TROUTVILLE, VA",2023-07-07,1,2,1
1087522376,"AUSTELL INTERMODAL, GA","SAN BERNARDINO, CA",2023-07-07,2,1,-1
3630108999,"LAKEVILLE, NY","EAST GRAND FORKS, MN",2023-07-07,11,8,-3
3630107503,"SANDUSKY DOCK, OH","CROOKED CREEK MINE, PA",2023-07-07,4,5,1
1087619563,"SELKIRK, NY","BUFFALO, NY",2023-07-07,3,1,-2
3630120129,"SINCO, TX","LOUISVILLE, KY",2023-07-07,4,2,-2
3630058047,"LONG BEACH E PIER, CA","COLUMBUS, OH",2023-07-07,5,8,3
1087581362,"CHARLOTTE, NC","SAN BERNARDINO, CA",2023-07-07,12,9,-3
3630132558,"LAMBERTS POINT, VA","WILLIAMSON YARD, WV",2023-07-07,7,5,-2
3630212594,"WINSTON-SALEM, NC","HOBBS, IN",2023-07-07,5,2,-3
3630212667,"WINSTON-SALEM, NC","HOBBS, IN",2023-07-07,3,6,3
3630212285,"CATAWBA, SC","SANTA CATARINA, NL",2023-07-07,4,1,-3
3630174827,"BALTIMORE DUNDALK M, MD","CHICAGO, IL",2023-07-07,9,9,0
1087563178,"SALINAS VICTORIA, NL","AUSTELL, GA",2023-07-07,2,1,-1
3630064462,"MERIDIAN, MS","RUTHERFORD, PA",2023-07-07,0,3,3
3630198601,"PRESA DE LA CEBADA, GJ","LEIPSIC, OH",2023-07-07,2,2,0
3630080052,"FERGUSON, MS","BRAMPTON, GA",2023-07-07,5,2,-3
3630076639,"LOS ANGELES, CA","MORRISVILLE, PA",2023-07-06,11,8,-3
1087312983,"LAMBERTS POINT, VA","TOMS CREEK, VA",2023-07-07,6,3,-3
1087709839,"NEW CASTLE, PA","PACIFIC, MO",2023-07-07,1,3,2
3630212065,"WINSTON-SALEM, NC","HOBBS, IN",2023-07-07,8,9,1
3630082208,"SALINAS VICTORIA, NL","AUSTELL, GA",2023-07-07,7,10,3
1087606251,"TOLEDO, OH","MIDDLETOWN, OH",2023-07-07,11,10,-1
3630057994,"LONG BEACH E PIER, CA","CINCINNATI, OH",2023-07-07,-2,1,3
3630184822,"BUFFALO, NY","BUFFALO, NY",2023-07-07,9,10,1
3630091859,"LOS ANGELES, CA","AUSTELL, GA",2023-07-07,6,3,-3
1087582897,"CROXTON, NJ","CHICAGO 47TH ST TV, IL",2023-07-07,0,3,3
3630127545,"TOLEDO, OH","INDIANA HARBOR, IN",2023-07-07,6,5,-1
3630213037,"MUNCY (LVRR), PA","CLAYTON (DCR), DE",2023-07-07,9,6,-3
3630109521,"RED DEER, AB","BLYTHEWOOD, SC",2023-07-07,3,1,-2
1087591579,"VALDOSTA, GA","MACON, GA",2023-07-07,2,4,2
3630098322,"NEW BERN, NC","BURNSVILLE, MS",2023-07-07,7,8,1
3630110629,"LOUDON, TN","CHAPMAN, PA",2023-07-07,9,9,0
1087530010,"RHEEMS, PA","CLAYPOOL, IN",2023-07-02,1,1,0
3628723050,"LAMBERTS POINT, VA","TOMS CREEK, VA",2023-07-07,8,5,-3
1087530426,"CROXTON, NJ","CHICAGO, IL",2023-07-07,9,8,-1
3630126696,"EIGHTY FOUR, PA","FALLING CREEK, NC",2023-07-07,9,9,0
3630125187,"BURNS HARBOR, IN","BURNS HARBOR, IN",2023-07-07,4,7,3
1087530450,"CHICAGO, IL","MORRISVILLE, PA",2023-07-07,7,8,1
1087616230,"BURNS HARBOR, IN","BURNS HARBOR, IN",2023-07-07,4,5,1
1087593555,"CHICAGO ENGLEW TV, IL","CHICAGO ENGLEW TV, IL",2023-07-07,-1,1,2
3630062931,"LOS ANGELES, CA","CROXTON, NJ",2023-07-07,-1,2,3
3630111976,"NEWBERRY, PA","WYEVILLE, WI",2023-07-05,9,8,-1
3629453739,"LAMBERTS POINT, VA","TOMS CREEK, VA",2023-07-07,5,6,1
3630205830,"WARRENTON, OH","SPARTA, WI",2023-07-07,11,8,-3
3630078885,"COLUMBIA CITY, IN","EAST CHICAGO, IN",2023-07-07,1,3,2
3630097253,"FREMONT, OH","WILLIAMS, CA",2023-07-07,8,7,-1
3630150417,"WOODSTOCK, ON","WESTLAKE, FL",2023-07-07,9,10,1
3630129822,"DARROW, IL","LAFAYETTE, IN",2023-07-07,-2,1,3
3630219520,"DECATUR, AL","CLARE, MI",2023-07-07,5,2,-3
3630108656,"CLYMERS, IN","ALBION, MI",2023-07-07,3,6,3
3630095219,"GATEWAY MINE, IL","WHEATFIELD, IN",2023-07-07,5,4,-1
3630187919,"MIAMI, FL","JACKSONVILLE, FL",2023-07-07,0,3,3
1087632765,"BAYARD, FL","MODESTO, CA",2023-07-07,5,5,0
3630057392,"SAN BERNARDINO, CA","CHARLOTTE, NC",2023-07-07,1,4,3
1087580633,"RUTHERFORD, PA","ROSSVILLE, TN",2023-07-07,8,6,-2
1087716323,"DECATUR, AL","CLARE, MI",2023-07-07,7,10,3
3630181874,"SELKIRK, NY","LAFAYETTE, IN",2023-07-07,3,5,2
1087537096,"CROXTON, NJ","ATLANTA, GA",2023-07-07,10,10,0
1087633559,"SIDNEY, IL","GUELPH, ON",2023-07-07,2,2,0
3630209321,"MELVINDALE, MI","KANSAS CITY, MO",2023-07-07,5,6,1
3630194110,"TITUSVILLE, FL","SAN BERNARDINO, CA",2023-07-07,7,6,-1
1087659872,"WYLIE, TX","ATLANTA, GA",2023-07-07,3,6,3
3630180187,"SHENANDOAH, PA","CLOVER BAR, AB",2023-07-07,7,7,0
1087533076,"LONG BEACH E PIER, CA","CLEVELAND, OH",2023-07-07,12,10,-2
1087605310,"SINCO, TX","LOUISVILLE, KY",2023-07-07,5,2,-3
3630211441,"WINSTON-SALEM, NC","HOBBS, IN",2023-07-07,2,1,-1
3630092473,"WAYNESBURG, PA","BETHLEHEM, PA",2023-07-07,10,8,-2
3630147032,"CLAVET, SK","GAINESVILLE, GA",2023-07-07,3,5,2
3630172053,"MEMPHIS, TN","MEMPHIS, TN",2023-07-07,13,10,-3
1087580918,"NEW BERN, NC","BURNSVILLE, MS",2023-07-07,1,3,2
3630060777,"CHICAGO, IL","TOLEDO, OH",2023-07-07,10,7,-3
3630117192,"FAIRFIELD, AL","BOEUF, LA",2023-07-07,-2,1,3
1087644712,"PT EVERGLADES, FL","BLAIR, NE",2023-07-07,4,2,-2
3630072986,"STEVENSON, AL","SAVANNAH, GA",2023-07-07,3,4,1
1087610234,"HUNTSVILLE, AL","SCOTTSBORO, AL",2023-07-07,10,10,0
3630055235,"LAMBERTS POINT, VA","WILLIAMSON YARD, WV",2023-07-07,7,10,3
1087530620,"BELLEVUE, OH","BELLEVUE, OH",2023-07-07,0,3,3
3630186379,"SAVANNAH, GA","EAST POINT, GA",2023-07-07,5,4,-1
3630067923,"CHARLOTTE INTER, NC","CHARLOTTE INTER, NC",2023-07-07,6,6,0
1087668512,"JERSEY, TN","CLYMERS, IN",2023-07-07,6,9,3
3630212714,"WINSTON-SALEM, NC","HOBBS, IN",2023-07-07,5,2,-3
3630080400,"HYCO, NC","BAILEY MINE, PA",2023-07-07,5,2,-3
3630145323,"ELDON, TX","YOUNGWOOD, PA",2023-07-07,9,8,-1
1087588990,"LOS ANGELES, CA","JACKSONVILLE, FL",2023-07-07,4,6,2
3630191641,"MONROE, OH","GRANITE CITY, IL",2023-07-07,8,10,2
3630146426,"DES MOINES, IA","DES MOINES, IA",2023-07-02,5,4,-1
3628722892,"LAMBERTS POINT, VA","TOMS CREEK, VA",2023-07-07,11,10,-1
3630115687,"STEELTON, PA","LACASSINE, LA",2023-07-07,4,5,1
1087623009,"BOWDEN YARD, FL","CHARLOTTE, NC",2023-07-07,9,9,0
3630203147,"LAMBERTS POINT, VA","TOMS CREEK, VA",2023-07-07,5,7,2
3630131471,"HARRISONVILLE, MO","OLD FORT, OH",2023-07-07,12,9,-3
3630093869,"MEMPHIS, TN","CHARLOTTE, NC",2023-07-07,-2,1,3
1087518987,"BELLEVUE, OH","FAIR OAKS, VA",2023-07-07,2,1,-1
3630063644,"TOLEDO AIRLINE, OH","TOLEDO AIRLINE, OH",2023-07-07,7,6,-1
3630072708,"WEST MONROE, LA","PORT WENTWORTH, GA",2023-07-07,4,4,0
3630066040,"DET JEFFERSON, MI","ROLLA, CO",2023-07-07,5,7,2
3630086278,"PRINCETON, IN","CANDLERIDGE, TX",2023-07-07,11,9,-2
3630171374,"YOUNGSTOWN, OH","NORTH BERGEN, NJ",2023-07-07,5,6,1
3630048678,"CICERO, IL","HARRISBURG, PA",2023-07-07,6,6,0
3630118457,"CRESSON, PA","CRAB ORCHARD, TN",2023-07-07,11,9,-2
3630081985,"SALINAS VICTORIA, NL","AUSTELL, GA",2023-07-07,4,3,-1
3630068212,"CHICAGO, IL","RUTHERFORD, PA",2023-07-07,8,5,-3
3630194615,"GIBSON CITY, IL","AUGUSTA, GA",2023-07-07,9,8,-1
3630187901,"MIAMI, FL","JACKSONVILLE, FL",2023-07-07,7,10,3
3630218469,"WYLIE, TX","ATLANTA, GA",2023-07-07,5,5,0
3630207361,"CLINTON, IA","DOUGHERTY, GA",2023-07-07,9,8,-1
1087602273,"RICHWOOD, KY","ORESTES, IN",2023-07-07,10,8,-2
3630130247,"DARROW, IL","LAFAYETTE, IN",2023-07-07,2,5,3
1087679987,"MERIDIAN, MS","MERIDIAN, MS",2023-07-07,5,5,0
1087661895,"MUNCY (LVRR), PA","LORDSTOWN, OH",2023-07-07,6,8,2
1087592892,"CLARKSON, ON","BAYWAY, NJ",2023-07-07,4,3,-1
3630073542,"SAN BERNARDINO, CA","HARRISBURG, PA",2023-07-07,10,10,0
3630153596,"PITTSFIELD, MA","KANKAKEE, IL",2023-07-07,3,3,0
3630135459,"LOS ANGELES, CA","HARRISBURG, PA",2023-07-07,8,5,-3
3630133863,"DES MOINES, IA","DES MOINES, IA",2023-07-07,6,3,-3
1087641683,"MIAMI, FL","CHICAGO 47TH ST TV, IL",2023-07-07,7,9,2
3630174576,"BRUNSWICK, GA","LOZETA, MO",2023-07-07,2,1,-1
3630114445,"DONALDSONVILLE, LA","FAIRLESS (TYBR), PA",2023-07-07,5,7,2
1087677888,"BETHINTERMODAL, PA","ST LOUIS, MO",2023-07-07,1,4,3
3630151861,"KEOKUK, IA","ALTOONA, PA",2023-07-07,-1,2,3
1087517826,"AUSTELL INTERMODAL, GA","LATHROP, CA",2023-07-07,7,6,-1
3630062656,"BEAVER DAM, KY","WESTVACO, WY",2023-07-07,5,2,-3
3630068262,"CHICAGO, IL","RUTHERFORD, PA",2023-07-07,13,10,-3
3630067729,"LOS ANGELES, CA","RUTHERFORD, PA",2023-07-07,9,8,-1
3630093908,"MEMPHIS, TN","CHARLOTTE, NC",2023-07-07,7,9,2
1087525942,"ST LOUIS, MO","RUTHERFORD, PA",2023-07-07,4,4,0
3630155116,"SPRING HILL, KS","PORTLAND, IN",2023-07-07,12,9,-3
3630048424,"STEELTON, PA","ATLANTA, GA",2023-07-07,1,2,1
3630168698,"SALEM, OH","STALEY, NC",2023-07-07,12,9,-3
3630072431,"IEIT, CA","GREENSBORO, NC",2023-07-07,9,10,1
3630163321,"HURON, CA","BRIDGEPORT (SLRS), NJ",2023-07-07,12,9,-3
3630146353,"DUDLEY, NC","SILLS, NY",2023-07-07,1,3,2
1087625687,"GREENSBORO, NC","PORTLAND, IN",2023-07-07,5,7,2
3630062703,"CLEVEDALE, SC","CALVERT, AL",2023-07-07,4,7,3
3630218126,"TULARE, CA","COLUMBUS, OH",2023-07-07,11,9,-2
1087656971,"BETHINTERMODAL, PA","SAN BERNARDINO, CA",2023-07-07,1,4,3
3630161939,"LACYMARK, FL","JUNCTION CITY, GA",2023-07-06,3,1,-2
3629821542,"SURRENCY, GA","ANDERSON (ICRK), IN",2023-07-07,5,3,-2
3630065507,"LOS ANGELES, CA","JACKSONVILLE, FL",2023-07-07,11,10,-1
3630091752,"LOS ANGELES, CA","JACKSONVILLE, FL",2023-07-07,7,5,-2
3630182707,"SANDERSVILLE, GA","ALCHEM, WY",2023-07-07,1,4,3
3630208626,"LOCK HAVEN, PA","BRILLS, NJ",2023-07-07,6,5,-1
3630108800,"CLYMERS, IN","CLYMERS, IN",2023-07-07,8,5,-3
3630134526,"WARREN, PA","INWOOD, WV",2023-07-07,0,2,2
3630144068,"CHICAGO ASHLAND AVE, IL","CLACKAMAS, OR",2023-07-07,5,6,1
3630137574,"ROBINSON, IL","DRAGON, MS",2023-07-07,11,8,-3
3630152053,"EAST ST LOUIS, IL","BLUFFTON, IN",2023-07-07,9,8,-1
3630056354,"LAMBERTS POINT, VA","WILLIAMSON YARD, WV",2023-07-04,10,10,0
3629203192,"LAMBERTS POINT, VA","TOMS CREEK, VA",2023-07-07,6,9,3
3630172744,"MARCUS, IA","ATLANTA, GA",2023-07-07,5,4,-1
3630194607,"GIBSON CITY, IL","AUGUSTA, GA",2023-07-07,13,10,-3
3630126785,"CONEY, MB","POMPANO BEACH, FL",2023-07-07,-2,1,3
3630131659,"GARNEAU, PQ","SPRING CITY, TN",2023-07-07,0,3,3
1087573652,"MACON, GA","SAINT JOHN, NB",2023-07-07,0,3,3
1087616280,"UNION BRIDGE, MD","DURHAM, NC",2023-07-07,0,3,3
1087536969,"CROXTON, NJ","ATLANTA, GA",2023-07-07,9,7,-2
1087713155,"KENOVA, WV","WEST HAZLETON, PA",2023-07-07,8,9,1
1087546338,"LOS ANGELES, CA","CROXTON, NJ",2023-07-02,5,5,0
3628757025,"CAROL, IN","FRANCISCO, IN",2023-07-06,2,2,0
3629782219,"LAMBERTS POINT, VA","TOMS CREEK, VA",2023-07-07,1,1,0
3630053039,"CRAWFORDSVILLE, IN","PEKIN, IL",2023-07-07,-1,1,2
3630090251,"MEMPHIS JCT, KY","NIXON, GA",2023-07-07,3,4,1
1087571854,"HAPEVILLE, GA","LOUDON, TN",2023-07-07,8,5,-3
3630072588,"COORS CROSSING, VA","EDDYVILLE, IA",2023-07-07,3,1,-2
1087652870,"GREER, SC","CHARLESTON, SC",2023-07-07,8,8,0
3630080751,"HYCO, NC","BAILEY MINE, PA",2023-07-07,7,6,-1
1087568487,"KANSAS CITY, MO","MELVINDALE, MI",2023-07-07,7,8,1
3630166400,"MAGNOLIA, GA","ROBERTA, AL",2023-07-07,5,2,-3
1087653143,"LACYMARK, FL","JUNCTION CITY, GA",2023-07-07,3,1,-2
1087574763,"LAFAYETTE, IN","LAFAYETTE, IN",2023-07-07,-2,1,3
3630210225,"BROOKLAWN, LA","RINCON, GA",2023-07-07,5,8,3
1087522928,"LAMBERTS POINT, VA","WILLIAMSON YARD, WV",2023-07-07,10,7,-3
3630112338,"RED DEER, AB","SYLACAUGA, AL",2023-07-07,7,7,0
3630142626,"DAVISVILLE, RI","LAFAYETTE, IN",2023-07-07,3,5,2
3630196764,"HODGES, TN","SELMA, NC",2023-07-07,3,2,-1
1087593806,"ELKHART, IN","SOUTH CHICAGO, IL",2023-07-07,2,1,-1
1087659131,"BRUNSWICK, GA","ARMSTRONG, GA",2023-07-07,5,7,2
3630051930,"BLUFFTON, IN","SELMA, NC",2023-07-07,8,7,-1
1087575531,"RIVERDALE, IL","RIVERDALE, IL",2023-07-07,9,9,0
3630161947,"LAFAYETTE, IN","TWINSBURG, OH",2023-07-07,5,5,0
3630087046,"KANSAS CITY, MO","MELVINDALE, MI",2023-07-07,2,5,3
1087694783,"AYER, MA","TOLEDO, OH",2023-07-07,2,5,3
3630094124,"MEMPHIS, TN","JACKSONVILLE, FL",2023-07-07,2,3,1
1087686104,"BAYONNE, NJ","WEST LAKE, LA",2023-07-07,4,3,-1
3630123347,"KANSAS CITY, MO","MELVINDALE, MI",2023-07-07,7,6,-1
1087643952,"SCIO, OH","EDDYSTONE, PA",2023-07-02,12,10,-2
3628723474,"LAMBERTS POINT, VA","TOMS CREEK, VA",2023-07-07,4,1,-3
1087633567,"STRANG, TX","MCINTOSH, AL",2023-07-02,5,7,2
3628751621,"LAMBERTS POINT, VA","TOMS CREEK, VA",2023-07-07,5,4,-1
3630107799,"SANDUSKY DOCK, OH","CROOKED CREEK MINE, PA",2023-07-07,-2,1,3
1087523021,"CAROL, IN","FRANCISCO, IN",2023-07-07,3,4,1
3630155035,"OLD FORT, OH","STE GENEVIEVE, MO",2023-07-07,11,10,-1
3630092198,"WELLSBORO, PA","WYEVILLE, WI",2023-07-07,7,4,-3
1087568437,"CHICAGO, IL","TITUSVILLE, FL",2023-07-07,1,2,1
3630067101,"SAN BERNARDINO, CA","CHARLOTTE, NC",2023-07-07,4,7,3
3630141484,"ASHEVILLE, NC","GIANT, SC",2023-07-04,7,6,-1
3629138711,"SANDUSKY DOCK, OH","CROOKED CREEK MINE, PA",2023-07-03,2,3,1
3628906470,"SANDUSKY DOCK, OH","CROOKED CREEK MINE, PA",2023-07-07,9,9,0
3630093762,"MEMPHIS, TN","CHARLOTTE, NC",2023-07-07,9,9,0
1087707382,"EAST CHICAGO, IN","LINDEN, NJ",2023-07-07,6,4,-2
1087680807,"SAVANNAH, GA","EAST POINT, GA",2023-07-07,5,8,3
1087706530,"CLAY, DE","SHIPPINGPORT, PA",2023-07-07,7,9,2
3630167464,"HOLLIDAYSBURG, PA","DRUMMOND, IL",2023-07-07,5,6,1
3630089593,"ELKHART, IN","GARNEAU, PQ",2023-07-07,2,4,2
3630170108,"LAFAYETTE, IN","LAFAYETTE, IN",2023-07-07,8,6,-2
3630055277,"WEST POINT, VA","TULARE, CA",2023-07-07,6,3,-3
1087560154,"CALVERT, AL","INDIANA HARBOR, IN",2023-07-07,12,9,-3
1087666332,"AUGUSTA, GA","MIAMI, FL",2023-07-07,4,2,-2
3630088319,"BOWDEN YARD, FL","BARIN, GA",2023-07-07,6,4,-2
3630200204,"WYLIE, TX","CHARLOTTE, NC",2023-07-07,2,2,0
1087628554,"MAPLE HEIGHTS, OH","NORFOLK INTERNATION, VA",2023-07-07,-2,1,3
3630211302,"OAKLAND, CA","NORFOLK INTERNATION, VA",2023-07-07,11,9,-2
3630158821,"BURNS HARBOR, IN","BURNS HARBOR, IN",2023-07-07,9,6,-3
3630052025,"BLUFFTON, IN","SELMA, NC",2023-07-07,6,5,-1
3630193499,"LOS ANGELES, CA","CROXTON, NJ",2023-07-07,3,5,2
3630071524,"MODESTO, CA","JACKSONVILLE, FL",2023-07-07,7,6,-1
1087544174,"ROSSER, GA","BARNESVILLE, GA",2023-07-07,6,7,1
3630196138,"PRINCETON, IN","MINNEAPOLIS, MN",2023-07-07,10,9,-1
1087692985,"CHICAGO ASHLAND AVE, IL","JOSLIN, IL",2023-07-07,12,10,-2
3630121256,"ROANOKE, VA","JOHNSON CITY, TN",2023-07-07,11,10,-1
3630104995,"BAYTOWN, TX","NORCROSS, GA",2023-07-07,4,6,2
3630068686,"CHICAGO, IL","COLUMBUS, OH",2023-07-07,1,1,0
1087614343,"MALLARD, AL","DECATUR, AL",2023-07-07,2,5,3
3630070188,"MIDDLETOWN, OH","WILLIAMSON YARD, WV",2023-07-07,2,4,2
3630165967,"KANSAS CITY, MO","MELVINDALE, MI",2023-07-07,6,6,0
3630107511,"SANDUSKY DOCK, OH","CROOKED CREEK MINE, PA",2023-07-07,5,6,1
1087549687,"HARRISBURG, PA","LATC, CA",2023-07-07,4,5,1
3630139746,"DECATUR, IL","HAPEVILLE, GA",2023-07-07,7,10,3
1087657498,"MERTZTOWN, PA","INDIANAPOLIS, IN",2023-07-07,6,4,-2
1087662362,"AYER, MA","IVORYDALE, OH",2023-07-07,5,8,3
3630097245,"WINSTON-SALEM, NC","CLAYPOOL, IN",2023-07-07,4,3,-1
1087680904,"WYLIE, TX","TITUSVILLE, FL",2023-07-07,6,7,1
1087529124,"CHICAGO ENGLEW TV, IL","CICERO, IL",2023-07-07,8,9,1
1087564051,"CALVERT CITY, KY","EMORY GAP, TN",2023-07-07,5,4,-1
1087638240,"ST PAUL, MN","JACKSONVILLE, FL",2023-07-07,5,6,1
3630080824,"HYCO, NC","BAILEY MINE, PA",2023-07-07,11,10,-1
1087544166,"ROSSER, GA","BARNESVILLE, GA",2023-07-07,0,3,3
3630085599,"LOS ANGELES, CA","CHARLOTTE, NC",2023-07-07,-2,1,3
3630203723,"LAMBERTS POINT, VA","TOMS CREEK, VA",2023-07-07,1,1,0
1087612765,"EDGERTON, IN","KINGS CREEK (DCR), MD",2023-07-07,7,7,0
3630097863,"WEST SHELBY, NC","HEPHZIBAH, GA",2023-07-07,3,1,-2
3630193041,"VERTAGREEN, AL","SILVER SPRINGS, NY",2023-07-07,6,9,3
3630203286,"LAMBERTS POINT, VA","TOMS CREEK, VA",2023-07-07,7,6,-1
3630199110,"LATHROP, CA","AUSTELL, GA",2023-07-07,11,9,-2
3630214994,"MAUMEE, OH","REYBOLD, DE",2023-07-07,3,3,0
3630211726,"WINSTON-SALEM, NC","HOBBS, IN",2023-07-07,1,2,1
3630180412,"WYLIE, TX","CHARLOTTE, NC",2023-07-07,0,3,3
3630158952,"EATONTON, GA","VANCE, AL",2023-07-07,9,10,1
3630157859,"PITTSFIELD, MA","KANKAKEE, IL",2023-07-07,11,9,-2
3630124416,"HUNTSVILLE, AL","SCOTTSBORO, AL",2023-07-05,5,3,-2
3629428001,"LAMBERTS POINT, VA","TOMS CREEK, VA",2023-07-07,9,10,1
1087635315,"BIRMINGHAM, MO","DETROIT DEARBORN, MI",2023-07-07,5,2,-3
3630186777,"CITY OF INDUSTRY, CA","ALBANY, NY",2023-07-07,2,4,2
3630114746,"RICHLAND, WA","MCDONOUGH, GA",2023-07-07,10,9,-1
3630052253,"BLUFFTON, IN","SELMA, NC",2023-07-07,11,9,-2
1087593474,"SARNIA, ON","ERIE, PA",2023-07-07,0,1,1
3630189822,"NEW ORLEANS, LA","NEW ORLEANS, LA",2023-07-07,0,2,2
3630151447,"EAST MODESTO, CA","ALTOONA, PA",2023-07-07,7,10,3
3630057300,"MAHRT (CCH), AL","AJAX, ON",2023-07-07,-1,2,3
3630215047,"SAVANNAH, GA","MEMPHIS, TN",2023-07-07,7,8,1
3630188614,"LAFAYETTE, IN","CLYMERS, IN",2023-07-07,9,6,-3
1087624932,"GREER, SC","CHARLESTON, SC",2023-07-07,11,9,-2
3630187692,"ANDERSONVILLE, GA","VANDALIA, MO",2023-07-07,11,10,-1
3630164602,"LAMBERTS POINT, VA","WILLIAMSON YARD, WV",2023-07-07,7,5,-2
3630146086,"MELVINDALE, MI","KANSAS CITY, MO",2023-07-07,8,7,-1
3630175873,"REIDSVILLE, NC","LEMOYNE, AL",2023-07-07,9,6,-3
1087605360,"BETHINTERMODAL, PA","CHICAGO, IL",2023-07-07,0,3,3
3630065604,"MONROE, MI","CHICAGO, IL",2023-07-07,9,7,-2
1087664495,"CHARLOTTE, NC","TACSIM, WA",2023-07-07,7,9,2
1087638177,"GEORGETOWN, SC","GYPSUM, OH",2023-07-07,3,6,3
3630052245,"BLUFFTON, IN","SELMA, NC",2023-07-07,7,4,-3
3630071215,"S JACKSONVILLE, FL","RUBY, GA",2023-07-07,0,3,3
1087620019,"SELKIRK, NY","BUFFALO, NY",2023-07-07,0,2,2
3630219635,"EAU CLAIRE, WI","PRESTON, GA",2023-07-07,9,10,1
3630212879,"WINSTON-SALEM, NC","HOBBS, IN",2023-07-07,2,3,1
1087561647,"HYCO, NC","BAILEY MINE, PA",2023-07-07,7,7,0
3630212471,"WINSTON-SALEM, NC","HOBBS, IN",2023-07-07,11,8,-3
3630203236,"LAMBERTS POINT, VA","TOMS CREEK, VA",2023-07-07,1,1,0
3630140365,"DODDVILLE, SC","STRANG, TX",2023-07-07,6,6,0
1087645043,"DECATUR, IL","BUTNER, NC",2023-07-07,6,7,1
1087576171,"MEMPHIS, TN","AUSTELL INTERMODAL, GA",2023-07-07,7,10,3
3630102587,"WYLIE, TX","ATLANTA, GA",2023-07-07,4,4,0
3630172760,"MARCUS, IA","ATLANTA, GA",2023-07-07,-2,1,3
1087703477,"FRANKFORT, IN","DECATUR, IL",2023-07-07,7,5,-2
3630058144,"LONG BEACH E PIER, CA","CINCINNATI, OH",2023-07-07,4,4,0
3630068343,"CHICAGO, IL","CROXTON, NJ",2023-07-07,6,6,0
3630049941,"TROUTVILLE, VA","WINSTON-SALEM, NC",2023-07-07,0,1,1
3630173596,"TWIN FALLS, ID","MCDONOUGH, GA",2023-07-07,4,6,2
1087596927,"CINCINNATI, OH","CINCINNATI, OH",2023-07-07,11,9,-2
3630147511,"DECATUR, IL","DECATUR, IL",2023-07-07,-1,1,2
3630190352,"EDGAR, FL","BRAMPTON, GA",2023-07-07,4,3,-1
3630086210,"PRINCETON, IN","DOREMUS AUTO RAMP, NJ",2023-07-07,9,6,-3
3630204957,"POSTELL, GA","JACKSONVILLE, FL",2023-07-07,0,1,1
3630139623,"MUNCY (LVRR), PA","LORDSTOWN, OH",2023-07-07,6,4,-2
1087654238,"MERIDIAN, MS","RUTHERFORD, PA",2023-07-07,6,8,2
1087714818,"AVON, NY","FRANKFORD (DCR), DE",2023-07-07,6,8,2
1087626439,"RALSTON, IA","DAYTON, VA",2023-07-07,-2,1,3
3630076401,"WYALUSING, PA","CHEEKTOWAGA, NY",2023-07-07,-2,1,3
3630212853,"WINSTON-SALEM, NC","HOBBS, IN",2023-07-07,5,7,2
3630094093,"MEMPHIS, TN","JACKSONVILLE, FL",2023-07-07,4,4,0
3630073429,"CHICAGO 47TH ST TV, IL","CHICAGO 47TH ST TV, IL",2023-07-07,10,8,-2
1087606811,"CLEVELAND, OH","NORFOLK INTERNATION, VA",2023-07-07,0,1,1
1087562596,"CALVERT, AL","INDIANA HARBOR, IN",2023-07-07,3,2,-1
3630075277,"ASHEBORO, NC","DECATUR, AL",2023-07-07,5,7,2
3630115302,"LOS ANGELES, CA","CROXTON, NJ",2023-07-07,6,6,0
3630087135,"ST PAUL, MN","HARRISBURG, PA",2023-07-07,2,2,0
3630174398,"PERRY, OH","PERRY, OH",2023-07-07,6,4,-2
1087540984,"SELMA, NC","SELMA, NC",2023-07-07,9,10,1
3630150378,"HENDERSON, KY","OWEGO, NY",2023-07-07,10,7,-3
3630170417,"MELVINDALE, MI","KANSAS CITY, MO",2023-07-07,3,4,1
1087579365,"BATH, PA","YOUNGSTOWN (YB), OH",2023-07-07,9,7,-2
3630102074,"HOUSTON, TX","ANNISTON, AL",2023-07-07,0,3,3
1087649322,"WEIRTON, WV","BURNS HARBOR, IN",2023-07-07,2,2,0
3630141450,"DUBLIN, GA","OTTAWA LAKE, MI",2023-07-07,9,8,-1
3630203472,"CORUNNA, ON","PIEDMONT, SC",2023-07-07,7,8,1
3630159403,"LOS ANGELES, CA","MIAMI, FL",2023-07-07,1,4,3
1087713448,"MCINTYRE, GA","STEVENS POINT, WI",2023-07-07,4,3,-1
1087558864,"LATHROP, CA","GREENSBORO, NC",2023-07-07,9,6,-3
1087618478,"BUFFALO, NY","CITY OF INDUSTRY, CA",2023-07-07,8,10,2
1087616735,"BURNS HARBOR, IN","BURNS HARBOR, IN",2023-07-07,1,3,2
1087523958,"BLUFFTON, IN","SELMA, NC",2023-07-07,4,1,-3
3630125357,"BURNS HARBOR, IN","BURNS HARBOR, IN",2023-07-07,4,7,3
3630219685,"LOS ANGELES, CA","JACKSONVILLE, FL",2023-07-07,6,8,2
3630203074,"LAMBERTS POINT, VA","TOMS CREEK, VA",2023-07-07,8,7,-1
3630117605,"MONROE, MI","NORTH BERGEN, NJ",2023-07-07,2,3,1
3630214156,"TAYLOR, PA","MAHRT (CCH), AL",2023-07-07,1,4,3
3630115467,"MT OLIVE, IL","BOISE SOUTHERN, LA",2023-07-07,8,10,2
1087672553,"ATLANTA, GA","RUTHERFORD, PA",2023-07-07,2,2,0
3630182765,"SALISBURY (DCR), MD","HILLSIDE, NJ",2023-07-07,1,2,1
3630185608,"MELVINDALE, MI","KANSAS CITY, MO",2023-07-07,7,10,3
3630175425,"DAYTON, TX","MONROEVILLE, OH",2023-07-07,3,4,1
3630076524,"LAMBERTS POINT, VA","WILLIAMSON YARD, WV",2023-07-07,10,8,-2
3630121337,"HUNTSVILLE, AL","SCOTTSBORO, AL",2023-07-07,8,7,-1
3630128216,"ROANOKE, VA","SOUTH RALEIGH, NC",2023-07-07,7,6,-1
1087690802,"AYER, MA","WILLIS, MI",2023-07-07,-1,2,3
3630091841,"MANKATO, MN","FRANKFORT, IN",2023-07-07,7,4,-3
1087608407,"GEORGETOWN, KY","CLEVELAND, OH",2023-07-07,9,6,-3
1087595345,"PINEVILLE, NC","CHICAGO, IL",2023-07-07,0,1,1
1087519682,"DETROIT, MI","WA UNITED TRM (WUT), WA",2023-07-07,-1,2,3
1087683449,"ST LOUIS, MO","BETHINTERMODAL, PA",2023-07-07,-2,1,3
1087648261,"SAVANNAH, GA","DORAVILLE, GA",2023-07-07,3,2,-1
3630216564,"SHAVER, AB","LOCK HAVEN NBER, PA",2023-07-07,10,8,-2
3630182139,"SELKIRK, NY","LAFAYETTE, IN",2023-07-07,9,6,-3
3630093592,"GARY, IN","ECORSE, MI",2023-07-07,10,9,-1
3630063474,"MCELHANY, MO","PORT WENTWORTH, GA",2023-07-07,-2,1,3
3630128193,"MARTINSBURG, WV","LEETSDALE, PA",2023-07-07,3,4,1
1087655705,"CHARLOTTE, NC","CHICAGO, IL",2023-07-07,2,5,3
3630057180,"LONG BEACH E PIER, CA","COLUMBUS, OH",2023-07-07,3,4,1
1087653046,"LACYMARK, FL","JUNCTION CITY, GA",2023-07-07,4,5,1
1087653135,"LACYMARK, FL","JUNCTION CITY, GA",2023-07-07,1,3,2
3630174592,"BALTIMORE DUNDALK M, MD","ARMOUR, IA",2023-07-07,8,9,1
1087549970,"STEVENSON, AL","SAVANNAH, GA",2023-07-07,3,6,3
3630062800,"INTERPUERTO, SL","AUSTELL, GA",2023-07-07,2,5,3
1087696816,"WEST HAZLETON, PA","NEAL, WV",2023-07-07,1,1,0
1087562025,"CALVERT, AL","INDIANA HARBOR, IN",2023-07-07,4,3,-1
3630197150,"SANDERSVILLE, GA","STEVENS POINT, WI",2023-07-07,6,5,-1
3630216514,"KENOVA, WV","DAYLIGHT, IN",2023-07-07,11,8,-3
3630167820,"RADFORD, NC","BELLEVUE, OH",2023-07-07,11,10,-1
3630152508,"AUBURNDALE, FL","JACKSONVILLE, FL",2023-07-07,4,2,-2
1087579315,"BATH, PA","YOUNGSTOWN (YB), OH",2023-07-07,8,5,-3
3630138863,"DALLAS, TX","HARRISBURG, PA",2023-07-07,8,7,-1
3630085808,"BOWDEN YARD, FL","CHARLOTTE, NC",2023-07-07,8,5,-3
1087699490,"ANCHORAGE, LA","LOUISVILLE, KY",2023-07-07,0,3,3
3630167189,"GARY, IN","MIDWEST PORTAGE, IN",2023-07-07,7,8,1
1087615593,"DARROW, IL","LAFAYETTE, IN",2023-07-07,4,5,1
1087617228,"MANSFIELD, OH","ELKIN, NC",2023-07-07,4,4,0
3630127650,"TOLEDO, OH","INDIANA HARBOR, IN",2023-07-07,4,6,2
3630127391,"BURNS HARBOR, IN","BURNS HARBOR, IN",2023-07-07,5,4,-1
3630197566,"SLCIT, UT","HARRISBURG, PA",2023-07-02,6,9,3
3628723555,"LAMBERTS POINT, VA","TOMS CREEK, VA",2023-07-07,9,10,1
3630182715,"HAZLEHURST, GA","BELCHERTOWN, MA",2023-07-07,8,7,-1
1087555599,"MELVINDALE, MI","KANSAS CITY, MO",2023-07-07,9,7,-2
3630136065,"BAYPORT, TX","POTTSTOWN, PA",2023-07-07,4,6,2
3630054700,"CAROL, IN","FRANCISCO, IN",2023-07-07,8,7,-1
1087670593,"TAYLOR, PA","TAYLOR, PA",2023-07-07,7,8,1
1087634929,"SHARONVILLE, OH","SHARONVILLE, OH",2023-07-07,8,5,-3
1087578369,"AUSTELL, GA","CHICAGO, IL",2023-07-07,7,9,2
1087612325,"GARLAND, TX","ASHEBORO, NC",2023-07-07,-1,2,3
3630177312,"MELVINDALE, MI","KANSAS CITY, MO",2023-07-07,12,10,-2
3630107731,"SANDUSKY DOCK, OH","CROOKED CREEK MINE, PA",2023-07-07,1,1,0
3630087931,"LEETSDALE, PA","MARTINSBURG, WV",2023-07-07,4,7,3
1087580146,"MORRISVILLE, PA","PHILADELPHIA, PA",2023-07-07,1,3,2
3630051419,"LAMBERTS POINT, VA","WILLIAMSON YARD, WV",2023-07-07,1,2,1
3630118588,"NEW ORLEANS, LA","TYNER, TN",2023-07-07,8,5,-3
3630125933,"NITRO (KNWA), WV","MARION, OH",2023-07-07,2,4,2
3630159673,"DALLAS, TX","NORFOLK, VA",2023-07-07,1,4,3
1087630878,"THOMASTON, IN","MONROE, MI",2023-07-07,0,1,1
3630111324,"WHITESTONE, SC","BAYONNE (EJR), NJ",2023-07-07,5,6,1
3630216213,"MARCUS HOOK, PA","MUNCIE, IN",2023-07-07,-2,1,3
3630071532,"LAMBERTS POINT, VA","WILLIAMSON YARD, WV",2023-07-07,11,8,-3
3630148410,"UNION LANDING SIDIN, OH","READING, PA",2023-07-07,5,4,-1
3630198855,"KANSAS CITY, MO","MELVINDALE, MI",2023-07-07,-2,1,3
3630108305,"VALDOSTA, GA","BURNSVILLE, MS",2023-07-07,6,3,-3
3630076744,"BARSTOW, CA","CROXTON, NJ",2023-07-06,10,8,-2
1087286158,"LAMBERTS POINT, VA","TOMS CREEK, VA",2023-07-07,7,9,2
1087580780,"NORFOLK, VA","NORFOLK, VA",2023-07-06,3,1,-2
3629778139,"LAMBERTS POINT, VA","TOMS CREEK, VA",2023-07-07,11,10,-1
3630059043,"STEVENSON, AL","VOLTZ, MO",2023-07-07,10,10,0
1087582871,"COVINGTON, VA","CHARLOTTE, NC",2023-07-07,2,3,1
1087552915,"CHICAGO, IL","PITTSBURGH, PA",2023-07-07,9,8,-1
3630214928,"BRACKENRIDGE, PA","BRISTOL, PA",2023-07-07,2,2,0
3630077211,"CALVERT, AL","WICHITA, KS",2023-07-07,5,8,3
3630056184,"MERIDIAN, MS","AUSTELL, GA",2023-07-07,4,2,-2
3630218689,"BAINBRIDGE, GA","SANDERSVILLE, MS",2023-07-07,6,4,-2
1087635349,"BIRMINGHAM, MO","DETROIT DEARBORN, MI",2023-07-07,2,5,3
3630072669,"LOS ANGELES, CA","AUSTELL, GA",2023-07-07,7,6,-1
1087653999,"BALDWIN, GA","DECATUR, IL",2023-07-07,4,7,3
3630205775,"WARRENTON, OH","SPARTA, WI",2023-07-07,5,5,0
3630092300,"WAYNESBURG, PA","BETHLEHEM, PA",2023-07-07,0,2,2
1087690399,"WEST POINT, VA","MOUNDSVILLE, WV",2023-07-07,7,10,3
3630098576,"ASHEVILLE, NC","PINE BLUFF, AR",2023-07-07,4,3,-1
1087575264,"HANNIBAL, MO","STOCKTON, CA",2023-07-07,6,5,-1
1087676604,"NORFOLK INTERNATION, VA","LANDERS, IL",2023-07-07,12,9,-3
1087551977,"ATLANTA, GA","RUTHERFORD, PA",2023-07-07,3,2,-1
1087612464,"DILLEY, TX","PICAYUNE, MS",2023-07-07,10,7,-3
3630112223,"MAHRT (CCH), AL","PORT WENTWORTH, GA",2023-07-07,-1,1,2
3630048725,"CICERO, IL","BETHINTERMODAL, PA",2023-07-07,6,8,2
3630169725,"WYLIE, TX","CHARLOTTE, NC",2023-07-07,10,7,-3
3630198237,"AYER, MA","TOLEDO, OH",2023-07-07,5,4,-1
3630073518,"CHICAGO 47TH ST TV, IL","CHICAGO 47TH ST TV, IL",2023-07-07,0,1,1
3630093924,"MEMPHIS, TN","CHARLOTTE, NC",2023-07-07,10,9,-1
3630209818,"FT WAYNE, IN","PIEDRAS NEGRAS, CU",2023-07-03,7,10,3
1086105773,"WINSTON-SALEM, NC","WHITE PIGEON, MI",2023-07-07,11,9,-2
3630061650,"LOS ANGELES, CA","CROXTON, NJ",2023-07-07,0,3,3
3630095269,"GATEWAY MINE, IL","WHEATFIELD, IN",2023-07-07,1,4,3
3630197273,"WINNEBAGO, MN","MACUNGIE, PA",2023-07-07,12,9,-3
1087543461,"CHICAGO, IL","COLUMBUS, OH",2023-07-07,10,10,0
1087547407,"AUSTELL INTERMODAL, GA","CHARLESTON, SC",2023-07-07,7,4,-3
3630153130,"COLUMBUS, OH","BUTLER, IN",2023-07-07,7,8,1
1087693826,"REEDSBURG, WI","SELMA, NC",2023-07-07,10,9,-1
3630211572,"EAST CHICAGO, IN","LINDEN, NJ",2023-07-07,-1,2,3
3630210877,"LATC, CA","MORRISVILLE, PA",2023-07-07,3,1,-2
1087551668,"SAVANNAH, GA","SAVANNAH, GA",2023-07-07,8,5,-3
3630092871,"RINCON, GA","BROOKLAWN, LA",2023-07-07,3,1,-2
1087704237,"WESTLAKE, FL","GEORGETOWN, KY",2023-07-07,4,3,-1
3630170548,"PETAL, MS","CAMBRIA, WI",2023-07-07,6,9,3
3630118635,"CRESSON, PA","CLEVELAND, OH",2023-07-07,5,3,-2
1087700013,"KNOX SEVIER YARD, TN","GEORGETOWN, SC",2023-07-07,-1,2,3
3630195302,"NORFOLK INTERNATION, VA","APPLIANCE PARK, KY",2023-07-07,6,9,3
3630130807,"MANSFIELD, OH","ELKIN, NC",2023-07-07,12,9,-3
3630054530,"CAROL, IN","FRANCISCO, IN",2023-07-07,7,9,2
3630218647,"BAINBRIDGE, GA","SANDERSVILLE, MS",2023-07-07,7,8,1
3630056922,"LONG BEACH E PIER, CA","CINCINNATI, OH",2023-07-07,3,3,0
1087689819,"CANNELTON (KNWA), WV","LAMBERTS POINT, VA",2023-07-07,1,2,1
1087546671,"LAMBERTS POINT, VA","WILLIAMSON YARD, WV",2023-07-07,12,10,-2
3630120658,"MARTINSBURG, WV","LEETSDALE, PA",2023-07-07,9,7,-2
3630061040,"CHICAGO, IL","CINCINNATI, OH",2023-07-07,8,5,-3
3630146832,"EAST ST LOUIS, IL","BLUFFTON, IN",2023-07-07,7,5,-2
3630052693,"BLUFFTON, IN","SELMA, NC",2023-07-07,7,8,1
3630081024,"HYCO, NC","BAILEY MINE, PA",2023-07-07,4,2,-2
3630151146,"DECATUR, IL","HOMER, IL",2023-07-07,-1,1,2
3630153685,"CLAVET, SK","GAINESVILLE, GA",2023-07-07,10,8,-2
3630153504,"WOODSTOCK, ON","WESTLAKE, FL",2023-07-07,1,2,1
3630085078,"LOS ANGELES, CA","JACKSONVILLE, FL",2023-07-07,0,3,3
3630055308,"LAMBERTS POINT, VA","WILLIAMSON YARD, WV",2023-07-07,-1,2,3
1087572038,"APPLIANCE PARK, KY","ELIZABETH MARINE TE, NJ",2023-07-07,7,7,0
1087644916,"BENTONITE, WY","CHATTANOOGA, TN",2023-07-06,3,3,0
3629744350,"LAMBERTS POINT, VA","TOMS CREEK, VA",2023-07-07,3,6,3
3630114576,"LOS ANGELES, CA","AUSTELL, GA",2023-07-07,6,3,-3
3630118774,"YORK, PA","EDGERTON, IN",2023-07-07,0,2,2
3630119445,"SPARTANBURG, SC","WINNIPEG, MB",2023-07-07,7,9,2
1087682647,"MIAMI, FL","JACKSONVILLE, FL",2023-07-07,7,5,-2
1087593092,"COLUMBUS, OH","PORTSMOUTH APMT, VA",2023-07-07,4,1,-3
3630060620,"CHICAGO, IL","CINCINNATI, OH",2023-07-07,8,10,2
3630203163,"LAMBERTS POINT, VA","TOMS CREEK, VA",2023-07-07,4,2,-2
1087663944,"LATHROP, CA","AUSTELL, GA",2023-07-07,7,9,2
1087601463,"LAFAYETTE, IN","LAFAYETTE, IN",2023-07-07,6,5,-1
3630067088,"BIRMINGHAM, AL","MIDDLETOWN, OH",2023-07-07,7,9,2
3630188135,"PORT WILMINGTON, DE","WESTVACO, WY",2023-07-07,1,2,1
1087596228,"COLUMBUS, OH","TACOMA, WA",2023-07-07,8,7,-1
1087644738,"PT EVERGLADES, FL","BLAIR, NE",2023-07-07,8,5,-3
3630205644,"CHOCOLATE BAYOU, TX","FINDERNE, NJ",2023-07-07,8,10,2
3630208456,"SAN BERNARDINO, CA","AUSTELL, GA",2023-07-07,8,9,1
3630179461,"STATE JCT, SC","GREER, SC",2023-07-07,4,7,3
3630172346,"BELLEVUE, OH","SEAFORD (DCR), DE",2023-07-07,11,9,-2
3630217170,"AUGUSTA, GA","HOLTON, VA",2023-07-07,6,3,-3
3630138334,"KINGSPORT, TN","LONGVIEW, TX",2023-07-07,2,3,1
3630072596,"LAGRANGE, NL","STERLING HEIGHTS, MI",2023-07-07,3,2,-1
3630195124,"CLEVELAND, OH","CLEVELAND, OH",2023-07-07,3,2,-1
1087543225,"BETHINTERMODAL, PA","SAN BERNARDINO, CA",2023-07-07,4,7,3
3630193986,"LAMBERTS POINT, VA","WILLIAMSON YARD, WV",2023-07-07,4,4,0
3630122587,"HOUSTON, TX","PEDRICKTOWN, NJ",2023-07-07,7,4,-3
1087575913,"MEMPHIS, TN","CHARLOTTE, NC",2023-07-07,0,1,1
3630149238,"COLUMBIA, SC","ELKHART, IN",2023-07-07,8,10,2
3630199623,"CEDAR RAPIDS, IA","SPARTANBURG, SC",2023-07-07,6,7,1
1087667710,"CHARLESTON, SC","GREER, SC",2023-07-07,0,1,1
3630167634,"ZORRA, ON","SIEGFRIED, PA",2023-07-07,9,10,1
3630093461,"WADSWORTH, TX","CLINTON, TN",2023-07-07,11,10,-1
3630086529,"LOS ANGELES, CA","RUTHERFORD, PA",2023-07-07,7,6,-1
3630210518,"BROOKLAWN, LA","RINCON, GA",2023-07-07,5,5,0
1087668499,"JERSEY, TN","CLYMERS, IN",2023-07-07,2,2,0
3630172150,"BATTLE MOUNTAIN, NV","HORSEHEADS, NY",2023-07-07,2,2,0
3630192778,"CLEVELAND, OH","COLUMBUS (CUOH), OH",2023-07-07,7,4,-3
3630132524,"LAMBERTS POINT, VA","WILLIAMSON YARD, WV",2023-07-07,12,9,-3
1087520340,"VOLTZ, MO","ELIZABETH MARINE TE, NJ",2023-07-07,12,10,-2
3630055007,"NORTH CHARLESTON, SC","DAYTON, TX",2023-07-07,8,8,0
1087692943,"MAUMEE, OH","TOLEDO, OH",2023-07-07,-1,1,2
3630128313,"MARTINSBURG, WV","MASSILLON (RSL), OH",2023-07-07,7,9,2
3630059483,"KNOXVILLE, TN","CHICAGO, IL",2023-07-07,8,8,0
1087523152,"CHICAGO, IL","HARRISBURG, PA",2023-07-07,10,7,-3
1087660506,"CHICAGO 47TH ST TV, IL","BETHINTERMODAL, PA",2023-07-04,10,8,-2
3629136882,"SANDUSKY DOCK, OH","CROOKED CREEK MINE, PA",2023-07-07,5,5,0
1087686447,"CLEVELAND, OH","WEST ELIZABETH, PA",2023-07-07,5,2,-3
3630116120,"KINGSPORT, TN","VOLTZ, MO",2023-07-07,10,8,-2
3630054491,"CAROL, IN","FRANCISCO, IN",2023-07-07,2,4,2
3630197231,"WINNEBAGO, MN","MACUNGIE, PA",2023-07-07,8,10,2
1087635292,"RUTHERFORD, PA","KANSAS CITY, MO",2023-07-07,8,10,2
1087612684,"EIGHTY FOUR, PA","FALLING CREEK, NC",2023-07-07,1,4,3
1087620695,"FLORENCE, SC","COLUMBIA, SC",2023-07-07,4,3,-1
1087521914,"CAROL, IN","FRANCISCO, IN",2023-07-07,2,1,-1
1087552169,"AUSTELL INTERMODAL, GA","GARDEN CITY, GA",2023-07-07,12,9,-3
1087568623,"CHICAGO, IL","TITUSVILLE, FL",2023-07-02,10,9,-1
3628756257,"CAROL, IN","FRANCISCO, IN",2023-07-07,4,3,-1
3630070154,"BARSTOW, CA","CROXTON, NJ",2023-07-07,3,6,3
3630094166,"MEMPHIS, TN","JACKSONVILLE, FL",2023-07-07,6,4,-2
3630080248,"HYCO, NC","BAILEY MINE, PA",2023-07-07,-1,1,2
1087689592,"CANNELTON (KNWA), WV","LAMBERTS POINT, VA",2023-07-07,6,9,3
1087704499,"VOLGA, SD","SADDLE BROOK, NJ",2023-07-07,9,10,1
1087696696,"CLYMERS, IN","HANNA, OH",2023-07-07,9,9,0
3630178075,"BUFFALO BISON, NY","NEW ORLEANS, LA",2023-07-07,3,5,2
3630080264,"HYCO, NC","BAILEY MINE, PA",2023-07-07,4,2,-2
3630082054,"LOS ANGELES, CA","RUTHERFORD, PA",2023-07-07,9,9,0
3630163151,"CLEVELAND, OH","CLEVELAND, OH",2023-07-07,12,9,-3
3630178740,"PALMERTON, PA","KNOXVILLE, TN",2023-07-07,2,3,1
1087574585,"LAFAYETTE, IN","LAFAYETTE, IN",2023-07-07,5,2,-3
1087653460,"COLUMBUS, OH","PORTLAND, OR",2023-07-07,5,7,2
1087625205,"ROBINSON, IL","DRAGON, MS",2023-07-07,-1,2,3
1087613363,"TOLEDO, OH","INDIANA HARBOR, IN",2023-07-07,5,4,-1
3630080272,"HYCO, NC","BAILEY MINE, PA",2023-07-07,8,10,2
3630072538,"BARSTOW, CA","HARRISBURG, PA",2023-07-07,3,3,0
1087662859,"DES MOINES, IA","DES MOINES, IA",2023-07-07,5,8,3
1087566663,"BOWDEN YARD, FL","PORTLAND, OR",2023-07-07,1,1,0
1087697252,"DALLAS, TX","HARRISBURG, PA",2023-07-07,10,9,-1
3630137100,"REDWOOD, MS","STATESVILLE (ARC), NC",2023-07-07,8,10,2
3630117011,"MORRISTOWN, TN","AMELIA, TX",2023-07-07,10,7,-3
3630094946,"GATEWAY MINE, IL","WHEATFIELD, IN",2023-07-07,9,9,0
3630181921,"SELKIRK, NY","LAFAYETTE, IN",2023-07-07,8,5,-3
1087559666,"WINSTON-SALEM, NC","CLAYPOOL, IN",2023-07-07,4,2,-2
3630166214,"NATKA (AIKR), SC","LAKE CHARLES, LA",2023-07-07,4,4,0
3630173130,"MINGO JCT, OH","BESSEMER, PA",2023-07-07,5,5,0
1087575214,"WAYNESBURG, PA","BETHLEHEM, PA",2023-07-07,4,1,-3
1087573759,"RUTHERFORD, PA","JACKSONVILLE, FL",2023-07-07,4,4,0
1087612113,"JACKSON, MI","BUTLER, IN",2023-07-07,3,2,-1
3630093990,"MEMPHIS, TN","JACKSONVILLE, FL",2023-07-07,9,6,-3
3630107935,"FARRELL, PA","PAULSBORO, NJ",2023-07-07,7,10,3
3630091451,"WINSTON-SALEM, NC","WHITE PIGEON, MI",2023-07-07,4,2,-2
1087523869,"BLUFFTON, IN","SELMA, NC",2023-07-07,6,3,-3
1087591927,"TERRE HAUTE, IN","BRACKENRIDGE, PA",2023-07-07,6,5,-1
3630199005,"LOS ANGELES, CA","MIAMI, FL",2023-07-07,1,3,2
3630100836,"MIAMI, FL","CHICAGO 47TH ST TV, IL",2023-07-07,9,10,1
1087677854,"BETHINTERMODAL, PA","ROSSVILLE, TN",2023-07-04,8,6,-2
3629138818,"SANDUSKY DOCK, OH","CROOKED CREEK MINE, PA",2023-07-07,4,4,0
1087580675,"PITCAIRN, PA","PITCAIRN, PA",2023-07-07,4,4,0
3630097415,"KANSAS CITY, MO","MELVINDALE, MI",2023-07-07,0,3,3
1087691905,"DECATUR, AL","FRANKLIN, IN",2023-07-07,8,10,2
3630132689,"SELKIRK, NY","BUFFALO, NY",2023-07-07,12,10,-2
3630088034,"BOWDEN YARD, FL","POSTELL, GA",2023-07-07,0,2,2
3630056998,"GARYVILLE, LA","GAINESVILLE, GA",2023-07-07,1,2,1
3630182074,"SELKIRK, NY","LAFAYETTE, IN",2023-07-07,-1,2,3
3630209232,"KANSAS CITY, MO","MELVINDALE, MI",2023-07-07,-2,1,3
1087637993,"PANAMA CITY, FL","ROME, GA",2023-07-07,7,8,1
3630149068,"PRINCETON, IN","PINE, IN",2023-07-07,6,7,1
1087645483,"MELVINDALE, MI","LIVERNOIS, MI",2023-07-07,-2,1,3
1087692804,"JACKSONVILLE, FL","PRINCETON, IN",2023-07-07,3,5,2
1087674301,"SHENANDOAH, PA","CLOVER BAR, AB",2023-07-07,9,7,-2
1087575701,"JACKSON, MI","WICHITA, KS",2023-07-07,4,4,0
3630070138,"ALLIANCE, TX","KANSAS CITY, KS",2023-07-06,6,4,-2
3629776747,"LAMBERTS POINT, VA","TOMS CREEK, VA",2023-07-07,7,10,3
3630127430,"TOLEDO, OH","INDIANA HARBOR, IN",2023-07-07,3,3,0
3630094970,"GATEWAY MINE, IL","WHEATFIELD, IN",2023-07-07,2,4,2
3630086765,"SELMA, AL","HAMMOND, IN",2023-07-07,9,6,-3
3630206404,"GREENVILLE, NJ","HOPEWELL, VA",2023-07-07,10,10,0
3630080662,"HYCO, NC","BAILEY MINE, PA",2023-07-07,4,5,1
3630205660,"BAYOU PIERRE, LA","DECATUR, AL",2023-07-07,10,9,-1
3630048539,"CICERO, IL","COLUMBUS, OH",2023-07-07,4,2,-2
3630193708,"LAMBERTS POINT, VA","WILLIAMSON YARD, WV",2023-07-07,10,7,-3
3630182163,"SELKIRK, NY","LAFAYETTE, IN",2023-07-07,3,6,3
1087577892,"GATEWAY MINE, IL","WHEATFIELD, IN",2023-07-07,5,4,-1
3630213689,"WINSTON-SALEM, NC","BIG ISLAND, WY",2023-07-07,0,2,2
1087635666,"WESTON, ON","BALTIMORE, MD",2023-07-07,1,1,0
1087546354,"SCHENECTADY, NY","TAYLOR, PA",2023-07-07,9,8,-1
3630077229,"CALVERT, AL","BIRMINGHAM, AL",2023-07-07,10,10,0
3630151413,"MIAMI, FL","CHICAGO 47TH ST TV, IL",2023-07-07,5,8,3
3630163622,"MERIDIAN, MS","RUTHERFORD, PA",2023-07-07,0,1,1
1087635250,"BIRMINGHAM, MO","DETROIT DEARBORN, MI",2023-07-07,5,8,3
3630113716,"CINCINNATI, OH","CINCINNATI, OH",2023-07-07,10,8,-2
3630190815,"CAREY, OH","DECATUR, IL",2023-07-07,7,9,2
3630099514,"KINGSPORT, TN","OSHKOSH, WI",2023-07-07,6,5,-1
3630063173,"PANZACOLA, TL","CALVERT, AL",2023-07-07,2,5,3
1087705982,"ORRVILLE, OH","EAST DECATUR, IL",2023-07-07,11,9,-2
3630159500,"ADDIS, LA","SOUTH ANDERSON, SC",2023-07-07,4,2,-2
3630175912,"REIDSVILLE, NC","LEMOYNE, AL",2023-07-07,13,10,-3
1087523762,"BLUFFTON, IN","SELMA, NC",2023-07-07,1,4,3
1087631735,"STAPLETON, GA","EAST STROUDSBURG, PA",2023-07-07,9,7,-2
3630129212,"PAULSBORO, NJ","TUCKAHOE, NJ",2023-07-07,1,2,1
1087656939,"EMIGSVILLE, PA","WARDEN, WA",2023-07-07,12,9,-3
3630094190,"MEMPHIS, TN","AUSTELL INTERMODAL, GA",2023-07-07,3,5,2
3630185145,"FT SMITH, AR","JACKSON, MI",2023-07-07,6,4,-2
3630062583,"LOS ANGELES, CA","RUTHERFORD, PA",2023-07-07,1,3,2
3630216205,"THEODORE, AL","DULUTH, GA",2023-07-07,9,10,1
3630215063,"CINCINNATI, OH","ROBY, IN",2023-07-07,0,2,2
1087632286,"APPLIANCE PARK, KY","PORTSMOUTH APMT, VA",2023-07-07,6,9,3
3630071689,"LAMBERTS POINT, VA","WILLIAMSON YARD, WV",2023-07-07,2,5,3
3630218710,"BAINBRIDGE, GA","SANDERSVILLE, MS",2023-07-07,6,7,1
3630120137,"SINCLAIR, WY","DECATUR, AL",2023-07-07,4,5,1
3630051134,"CLEVEDALE, SC","CALVERT, AL",2023-07-07,9,7,-2
3630099093,"CITY OF INDUSTRY, CA","GREENSBORO, NC",2023-07-07,9,7,-2
3630193164,"MONTREAL EAST, PQ","MARION, IN",2023-07-07,7,7,0
3630166581,"FREEPORT, TX","LEWISTOWN (JVRR), PA",2023-07-07,12,10,-2
3630207573,"CLINTON, IA","DOUGHERTY, GA",2023-07-07,5,2,-3
3630105577,"SAVANNAH, GA","MADISON, AL",2023-07-07,9,10,1
3630138596,"CLEARING CHGO, IL","LEWISTOWN (JVRR), PA",2023-07-07,7,7,0
1087693193,"JACKSONVILLE, FL","VOLTZ MIX CTR, MO",2023-07-07,3,2,-1
3630140616,"LAMBERTS POINT, VA","WILLIAMSON YARD, WV",2023-07-07,2,2,0
1087615145,"ROSSVILLE, TN","RUTHERFORD, PA",2023-07-07,2,2,0
3630103305,"SHELBYVILLE, KY","CARTERET, NJ",2023-07-07,4,7,3
3630093411,"BIRMINGHAM, MO","CHICAGO HEIGHTS, IL",2023-07-07,7,7,0
3630107977,"LIMEDALE, IN","FT WAYNE, IN",2023-07-07,7,9,2
1087542431,"CALVERT, AL","WICHITA, KS",2023-07-07,6,4,-2
3630149741,"PLAQUEMINE, LA","GRANITE FALLS, NC",2023-07-07,7,4,-3
1087610844,"JACKSONVILLE, FL","PRINCETON, IN",2023-07-07,5,6,1
1087540081,"DECATUR, IL","BIG ISLAND, WY",2023-07-07,7,7,0
3630213883,"SAVANNAH, GA","WACO, TX",2023-07-07,7,5,-2
1087658761,"WAYNE, MI","ECORSE, MI",2023-07-07,4,4,0
3630078356,"SHELBYVILLE, IN","NORFOLK, VA",2023-07-07,10,9,-1
3630074475,"LOS ANGELES, CA","JACKSONVILLE, FL",2023-07-07,5,6,1
3630110904,"MIAMI, FL","VALDOSTA, GA",2023-07-07,9,9,0
3630049967,"TROUTVILLE, VA","SELMA, NC",2023-07-07,12,9,-3
1087696280,"CEDAR RAPIDS, IA","SPARTANBURG, SC",2023-07-07,9,8,-1
3630138716,"MUNCY (LVRR), PA","LORDSTOWN, OH",2023-07-07,-1,2,3
3630191853,"NEW ORLEANS, LA","LORENZO, IL",2023-07-07,0,2,2
3630169709,"WAYNESBORO, VA","UNION BRIDGE, MD",2023-07-07,1,1,0
3630158130,"BURNS HARBOR, IN","BURNS HARBOR, IN",2023-07-07,2,1,-1
1087666748,"BRUNSWICK, GA","LOZETA, MO",2023-07-07,10,8,-2
3630049721,"TROUTVILLE, VA","BRISTOL, VA",2023-07-07,4,5,1
1087520536,"CHICAGO, IL","ALBANY, NY",2023-07-06,9,9,0
1087201459,"LAMBERTS POINT, VA","TOMS CREEK, VA",2023-07-07,3,1,-2